мту - ['мту']
callцентр - ['callцентр']
адаптация - ['адаптация']
оснастить - ['оснастить']
партия - ['партия']
чемпионат - ['чемпионат']
устный - ['устный']
епг - ['епг']
годаприложение - ['годаприложение']
айгуль - ['айгуль']
бизнесаналитик - ['бизнесаналитика']
телемаркетинг - ['телемаркетинг']
никто - ['никто']
домru - ['домru']
этнополитика - ['этнополитика']
бм - ['бм']
магнетизм - ['магнетизм']
союз - ['союз']
деньга - ['деньга']
латинский - ['латинский']
экономистфинансист - ['экономистфинансист']
минемтукать - ['минемтукать']
антропология - ['антропология']
гилязутдин - ['гилязутдинов']
привязка - ['привязка']
высотный - ['высотный']
хайруллин - ['хайруллин']
татармультфильм - ['татармультфильм']
признавать - ['признавать']
ноябрь - ['ноябрь']
услон - ['услон']
инфаркт - ['инфаркт']
отобрать - ['отобрать']
отдать - ['отдать']
имлайтннг - ['имлайтннг']
секретарьалексей - ['секретарьалексеев']
математик - ['математика', 'математик']
dolore - ['dolore']
cпециалиста - ['cпециалиста']
клетчатка - ['клетчатка']
снимка - ['снимок']
насосный - ['насосный']
светлана - ['светлана']
академия - ['академия']
узбекистан - ['узбекистан']
уставный - ['уставный']
дб - ['дб']
roadмайxxiii - ['roadмайxxiii']
микрореакция - ['микрореакция']
целое - ['целое']
жить - ['жить']
наркотизация - ['наркотизация']
видеорепортаж - ['видеорепортаж']
симпозиум - ['симпозиум']
амсг - ['амсг']
анадырь - ['анадырь']
поволжье - ['поволжье']
яндекс - ['яндекс']
татхимфармпрепарат - ['татхимфармпрепарат']
двор - ['двор']
агроторг - ['агроторг']
личность - ['личность']
лукойлинтеркард - ['лукойлинтеркард']
для - ['для']
освоение - ['освоение']
го - ['го']
свет - ['свет']
услуга - ['услуга']
группа - ['группа']
рф - ['рф']
аверс - ['аверс']
шаяхмет - ['шаяхметов']
гибридный - ['гибридный']
ташкент - ['ташкент']
двое - ['двое']
среди - ['среди']
fr - ['fr']
priemchelnykpfuru - ['priemchelnykpfuru']
агроэкосистема - ['агроэкосистема']
малайзия - ['малайзия']
customer - ['customer']
аагромыко - ['аагромыко']
еи - ['еи']
шаянтв - ['шаянтв']
азия - ['азия']
стр - ['стр']
туркменистан - ['туркменистан']
джизак - ['джизак']
финалист - ['финалист']
аптечный - ['аптечный']
расход - ['расход']
рамирес - ['рамирес']
г - ['г']
лежать - ['лежать']
university - ['university']
минзарип - ['минзарип', 'минзарипов']
сеть - ['сеть']
лабораторный - ['лабораторный']
траектория - ['траектория']
литвин - ['литвин']
грамотный - ['грамотный']
гатауллович - ['гатауллович']
пос - ['пос']
with - ['with']
асутп - ['асутп']
наилевич - ['наилевич']
отв - ['отв']
күңелләрный - ['күңелләрный']
left - ['left']
симонов - ['симонов']
liceumkpfuinboxru - ['liceumkpfuinboxru']
экономикоправовой - ['экономикоправовой']
пфо - ['пфо']
иной - ['иной']
саидгалеев - ['саидгалеев']
увп - ['увп']
кровь - ['кровь']
кинопоказ - ['кинопоказ']
доклад - ['доклад']
росреестр - ['росреестр']
медосмотр - ['медосмотр']
николаенко - ['николаенко']
филологиня - ['филологиня']
акушерство - ['акушерство']
adios - ['adios']
администрация - ['администрация']
use - ['use']
комплексный - ['комплексный']
затронуть - ['затронуть']
tourismuniversummail - ['tourismuniversummail']
имвпчкалов - ['имвпчкалов']
санктпетербург - ['санктпетербург']
делегация - ['делегация']
операторзаправщик - ['операторзаправщик']
логотип - ['логотип']
ппк - ['ппк']
методика - ['методика']
волков - ['волков']
астрофизик - ['астрофизик']
взгляд - ['взгляд']
дбн - ['дбн']
шанс - ['шанс']
црр - ['црр']
кан - ['кан']
энергия - ['энергия']
bonration - ['bonration']
фармакология - ['фармакология']
облако - ['облако']
нажимать - ['нажимать']
тезис - ['тезис']
аф - ['аф']
территория - ['территория']
уголовный - ['уголовный']
смерть - ['смерть']
концертный - ['концертный']
конфликт - ['конфликт']
telegram - ['telegram']
делопроизводство - ['делопроизводство']
covariance - ['covariance']
телевидение - ['телевидение']
healthy - ['healthy']
претендент - ['претендент']
yota - ['yota']
зелёный - ['зелёный']
тр - ['тр']
полёт - ['полёт']
призовой - ['призовой']
мгимо - ['мгимо']
ниу - ['ниу']
экомарафон - ['экомарафон']
itиндустрия - ['itиндустрия']
дрконференция - ['дрконференция']
сайдуллаев - ['сайдуллаев']
buddy - ['buddy']
прод - ['прод']
экономикематематика - ['экономикематематика']
вебквест - ['вебквест']
полимер - ['полимер']
пилотный - ['пилотный']
энгельгардт - ['энгельгардт']
gizatullinanatamailru - ['gizatullinanatamailru']
интерьер - ['интерьер']
книга - ['книга']
специалист - ['специалист']
media - ['media']
корпорация - ['корпорация']
рамзия - ['рамзия']
школаинтернат - ['школаинтернат']
гильмутдин - ['гильмутдинов']
язык - ['язык']
is - ['is']
аэропорт - ['аэропорт']
пуртовыя - ['пуртовый']
бутлер - ['бутлеров']
усадский - ['усадский']
геофизик - ['геофизик']
кардиолог - ['кардиолог']
пациент - ['пациент']
research - ['research']
преодолеть - ['преодолеть']
селезёнка - ['селезёнка']
данный - ['данный']
эфтечь - ['эфтечь']
global - ['global']
бик - ['бик']
располагать - ['располагать']
xix - ['xix']
компонент - ['компонент']
вычитка - ['вычитка']
буклет - ['буклет']
фанк - ['фанк']
индонезия - ['индонезия']
вт - ['вт']
казаский - ['казаский']
подземный - ['подземный']
докторантура - ['докторантура']
регин - ['регин']
артериальный - ['артериальный']
ты - ['ты']
уклон - ['уклон']
ривьера - ['ривьера']
функция - ['функция']
фаикович - ['фаикович']
парный - ['парный']
ашан - ['ашан']
информатика - ['информатика']
nx - ['nx']
аспирант - ['аспирант']
издание - ['издание']
разногласие - ['разногласие']
маленький - ['маленький']
докторант - ['докторант']
зай - ['зай']
бугульма - ['бугульма']
благополучие - ['благополучие']
отметка - ['отметка']
мо - ['мо']
откровение - ['откровение']
гкорпоративный - ['гкорпоративный']
борт - ['борт']
ссузов - ['ссузов']
уфпс - ['уфпс']
ый - ['ый']
связь - ['связь']
computing - ['computing']
commodo - ['commodo']
медиаинжиниринг - ['медиаинжиниринг']
мвд - ['мвд']
мечта - ['мечта']
шестой - ['шестой']
номер - ['номер']
порядок - ['порядок']
родиться - ['род', 'родиться']
временной - ['временной']
сдача - ['сдача']
онлайнконкурс - ['онлайнконкурс']
сленг - ['сленг']
квартира - ['квартира']
институтапрограмма - ['институтапрограмма']
интеллект - ['интеллект']
treningcenterkpfuru - ['treningcenterkpfuru']
трендпрактик - ['трендпрактик']
помидор - ['помидор']
понять - ['понять']
островград - ['островград']
анодый - ['анодый']
газпром - ['газпром']
solutions - ['solutions']
evalag - ['evalag']
сортировщик - ['сортировщик']
экземпляр - ['экземпляр']
географиярусский - ['географиярусский']
ева - ['ева']
окружающий - ['окружающий']
восток - ['восток']
мебель - ['мебель']
ризосферный - ['ризосферный']
мультимедийный - ['мультимедийный']
видеосвязь - ['видеосвязь']
цифровизация - ['цифровизация']
триггер - ['триггера']
запад - ['запад']
привиться - ['привиться']
иэк - ['иэк']
iigibadullinakpfuru - ['iigibadullinakpfuru']
microsoft - ['microsoft']
teams - ['teams']
муслимат - ['муслимат']
телефонмоб - ['телефонмоб']
технологиймагистратура - ['технологиймагистратура']
врачтерапевт - ['врачтерапевт']
магнитный - ['магнитная', 'магнитный']
технологиябиология - ['технологиябиология']
резонансный - ['резонансный']
выдать - ['выдать']
борис - ['борисов']
остаться - ['остаться']
деревня - ['деревня']
филологиять - ['филологиять']
вовсе - ['вовсе']
техотдел - ['техотдел']
успешный - ['успешный']
аналог - ['аналог']
рфяцвнииэф - ['рфяцвнииэф']
егэогэ - ['егэогэ']
мб - ['мб']
univer - ['univer']
сумма - ['сумма']
nafadeevakpfuru - ['nafadeevakpfuru']
kmlckpfuru - ['kmlckpfuru']
зтэо - ['зтэо']
technologiesконтакт - ['technologiesконтакт']
повысить - ['повысить']
широта - ['широта']
графика - ['графика']
челны - ['челны']
миллион - ['миллион']
реабилитация - ['реабилитация']
андеррайтер - ['андеррайтер']
радиоэлектроника - ['радиоэлектроника']
твой - ['твой']
фи - ['фи']
оnline - ['оnline']
иргалина - ['иргалина']
email - ['email']
присвоить - ['присвоить']
xl - ['xl']
унять - ['унять']
стадия - ['стадия']
канадзав - ['канадзав']
аделий - ['аделий']
роботехника - ['роботехника']
свод - ['свод']
климат - ['климат']
позаботиться - ['позаботиться']
иас - ['иас']
гуськов - ['гуськов']
связииконка - ['связииконка']
оформлять - ['оформлять']
медицион - ['медицион']
пасть - ['пасть']
хетам - ['хетам']
бульвар - ['бульвар']
гумерович - ['гумерович']
пг - ['пг']
секретариат - ['секретариат']
моллай - ['моллай']
шипил - ['шипил']
инженерлаборант - ['инженерлаборант']
skills - ['skills']
doors - ['doors']
тинькофф - ['тинькофф']
ситуация - ['ситуация']
сквер - ['сквер']
центрреализация - ['центрреализация']
талантливый - ['талантливый']
мухаметгалий - ['мухаметгалиев']
акот - ['акот']
палеомагнетизм - ['палеомагнетизм']
команда - ['команда']
трудящийся - ['трудящийся']
семестр - ['семестр']
иткомпания - ['иткомпания']
то - ['то']
ц - ['ц']
депутат - ['депутат']
экспертиза - ['экспертиза']
роальд - ['роальд']
вторник - ['вторник']
emailelabugakpfuru - ['emailelabugakpfuru']
проректоррг - ['проректоррг']
прошлое - ['прошлое']
iii - ['iii']
спортгарда - ['спортгарда']
космология - ['космология']
инженерпроектировщик - ['инженерпроектировщик']
xxi - ['xxi']
радиотехник - ['радиотехник']
ватуманов - ['ватуманов']
алесь - ['алесь']
эор - ['эор']
практикетаблица - ['практикетаблица']
кироа - ['кироа']
са - ['са']
узнать - ['узнать']
чдоу - ['чдоу']
маврина - ['маврина']
наукиметод - ['наукиметод']
сверяться - ['сверяться']
транспортный - ['транспортный']
специалистэксперт - ['специалистэксперт']
httpsscholargooglecomcitationshlenusersbhoaaaaj - ['httpsscholargooglecomcitationshlenusersbhoaaaaj']
право - ['право']
httpworkingpapersruobrazecrezumehtml - ['httpworkingpapersruobrazecrezumehtml']
бикмаев - ['бикмаев']
миграция - ['миграция']
аудэкс - ['аудэкс']
выдохнуть - ['выдохнуть']
открытый - ['открытый']
вирусология - ['вирусология']
unidamumailru - ['unidamumailru']
бинбанк - ['бинбанк']
протокол - ['протокол']
tat - ['tat']
нэфисбиопродукт - ['нэфисбиопродукт']
dislike - ['dislike']
geniwell - ['geniwell']
энергоснабжающий - ['энергоснабжающий']
доза - ['доза']
приходиться - ['приходиться']
бухараев - ['бухараев']
юд - ['юд']
регистрация - ['регистрация']
рфпервый - ['рфпервый']
гидросфера - ['гидросфера']
роза - ['роза']
штука - ['штука']
прописать - ['прописать']
сосудистый - ['сосудистый']
активно - ['активно']
docx - ['docx']
интернетверсия - ['интернетверсия']
изоляция - ['изоляция']
среда - ['среда']
алексеевич - ['алексеевич']
uniqlo - ['uniqlo']
никакой - ['никакой']
тонус - ['тонус']
возраст - ['возраст']
прогноз - ['прогноз']
срочно - ['срочно']
сардек - ['сардек']
мера - ['мера']
клиент - ['клиент']
the - ['the']
уч - ['уч']
стать - ['стать']
панелька - ['панелька']
задача - ['задача']
галочка - ['галочка']
бюрократос - ['бюрократос']
дарелфанун - ['дарелфанун']
биоэтика - ['биоэтика']
плюс - ['плюс']
водоканал - ['водоканал']
дурной - ['дурной']
инженерагеофизика - ['инженерагеофизика']
конфликтология - ['конфликтология']
клетка - ['клетка']
fiesta - ['fiesta']
доля - ['доля']
муп - ['муп']
верхний - ['верхний']
дайджест - ['дайджест']
total - ['total']
кс - ['кс']
играть - ['играть']
мелкооптовый - ['мелкооптовый']
прочий - ['прочий']
калининград - ['калининград']
переселенец - ['переселенец']
профпатология - ['профпатология']
этнография - ['этнография']
укол - ['укол']
населять - ['населять']
старание - ['старание']
климатология - ['климатология']
юрилект - ['юрилект']
малый - ['малое', 'малый']
что - ['что']
светогорск - ['светогорск']
текстология - ['текстология']
совладелец - ['совладелец']
кружка - ['кружка']
исходить - ['исходить']
версия - ['версия']
kfufpkmailru - ['kfufpkmailru']
crookpfuruинформация - ['crookpfuruинформация']
оптимизм - ['оптимизм']
семинарский - ['семинарский']
olegmavrinkpfuru - ['olegmavrinkpfuru']
акмеология - ['акмеология']
домемузей - ['домемузей']
демография - ['демография']
югра - ['югра']
билгеся - ['билгеся']
фондовый - ['фондовый']
санктпетербургский - ['санктпетербургский']
нефтяной - ['нефтяной']
созидание - ['созидание']
и - ['и']
конец - ['конец']
оружие - ['оружие']
десант - ['десант']
оптика - ['оптика']
разведка - ['разведка']
николаевич - ['николаевич']
ispring - ['ispring']
гэмбнуть - ['гэмбла']
свыше - ['свыше']
руб - ['руб']
kafanglnemmailru - ['kafanglnemmailru']
прописка - ['прописка']
сертификация - ['сертификация']
зам - ['зам']
бренд - ['бренд']
краткий - ['краткий']
нпп - ['нпп']
габдулхак - ['габдулхак']
насырь - ['насырь']
число - ['число']
микробиолог - ['микробиолог']
учёный - ['учёный']
онтология - ['онтология']
касса - ['касса']
office - ['office']
кирилл - ['кирилл']
онтогенез - ['онтогенез']
бюст - ['бюст']
няня - ['няня']
тип - ['тип']
принимать - ['принимать']
ифнс - ['ифнс']
ячейка - ['ячейка']
предупреждение - ['предупреждение']
рентгенология - ['рентгенология']
ось - ['ось']
устройство - ['устройство']
обед - ['обед']
студентамшкола - ['студентамшкол']
решать - ['решать']
гэк - ['гэк']
секрет - ['секрет']
рауфович - ['рауфович']
прессцентр - ['прессцентр']
алкоголь - ['алкоголь']
атмосферный - ['атмосферный']
чешева - ['чешева']
нагрузка - ['нагрузка']
факт - ['факт']
инвалид - ['инвалид']
парад - ['парад']
экстрагент - ['экстрагент']
мр - ['мр']
поручить - ['поручить']
фотошоп - ['фотошоп']
nasibullovramismailru - ['nasibullovramismailru']
нужный - ['нужный']
тот - ['тот']
нигматуллин - ['нигматуллин']
именно - ['именно']
рынок - ['рынок']
гмичеринск - ['гмичеринск']
берлин - ['берлин']
фотоальбом - ['фотоальбом']
жизнь - ['жизнь']
начинать - ['начинать']
фильм - ['фильм']
капитал - ['капитал']
операция - ['операция']
типовой - ['типовой']
европа - ['европа']
горобец - ['горобец']
атааналар - ['атааналар']
трёхдневный - ['трёхдневный']
logi - ['logi']
напрямую - ['напрямую']
аспушкин - ['аспушкин']
новатэктаркосаленефтегаз - ['новатэктаркосаленефтегаз']
толстовский - ['толстовский']
макромера - ['макромера']
ганиев - ['ганиев']
рана - ['рана']
перекрёсток - ['перекрёсток']
бизнескомпания - ['бизнескомпания']
удостоверение - ['удостоверение']
сми - ['сми']
вбг - ['вбг']
чоу - ['чоу']
mrsej - ['mrsej']
шх - ['шх']
волжский - ['волжский']
сириус - ['сириус']
youtubeканал - ['youtubeканал']
фгуп - ['фгуп']
знать - ['знать']
отчисление - ['отчисление']
отдых - ['отдых']
ултатарстан - ['ултатарстан']
помочь - ['помочь']
нужно - ['нужно']
немало - ['немало']
вагон - ['вагон']
fair - ['fair']
камавтоцентр - ['камавтоцентр']
скамья - ['скамья']
pkefkfugmailcom - ['pkefkfugmailcom']
битый - ['битый']
политика - ['политика']
углублённый - ['углублённый']
средний - ['средний', 'среднее']
изменить - ['изменить']
бы - ['бы']
камиль - ['камиль']
администратор - ['администратор']
солнце - ['солнце']
привыкнуть - ['привыкнуть']
tape - ['tape']
талант - ['талант']
контраверсия - ['контраверсия']
одежда - ['одежда']
спа - ['спа']
геометрия - ['геометрия']
строго - ['строго']
юристконсульт - ['юристконсульт']
губернатор - ['губернатор']
набчелны - ['набчелны']
неполный - ['неполный']
морфология - ['морфология']
сценарий - ['сценарий']
приурочить - ['приурочить']
предложение - ['предложение']
наталья - ['наталья']
выиграть - ['выиграть']
артек - ['артек']
международник - ['международник']
татнефтьалабуг - ['татнефтьалабуг']
лингвополикультурный - ['лингвополикультурный']
эксперимент - ['эксперимент']
кабачок - ['кабачок']
казан - ['казан']
кфэя - ['кфэя']
заявлениедокумент - ['заявлениедокумент']
выпуск - ['выпуск']
учить - ['учить']
елена - ['елена']
аэс - ['аэс']
телек - ['телек']
asg - ['asg']
сервисинженер - ['сервисинженер']
кфуреестр - ['кфуреестр']
саммит - ['саммит']
прибытие - ['прибытие']
огэ - ['огэ']
остров - ['остров']
java - ['java']
айдар - ['айдар']
балакирев - ['балакирев']
nodefieldprisvaivaemaastepenfieldprisvaivaemaastepenvalue - ['nodefieldprisvaivaemaastepenfieldprisvaivaemaastepenvalue']
приложение - ['приложение']
масштабный - ['масштабный']
авиа - ['авиа']
духовность - ['духовность']
skyeng - ['skyeng']
дистрибьютор - ['дистрибьютор']
co₂ - ['co₂']
virtual - ['virtual']
грация - ['грация']
ойлэкт - ['ойлэкт']
контрацепция - ['контрацепция']
иофха - ['иофха']
чтение - ['чтение']
положениеоткрыть - ['положениеоткрыть']
быков - ['быков']
news - ['news']
университетовучастник - ['университетовучастник']
adipiscing - ['adipiscing']
conservation - ['conservation']
ученыххимик - ['ученыххимик']
кунаклара - ['кунаклара']
реферативный - ['реферативный']
сессия - ['сессия']
таджикистан - ['таджикистан']
перспектива - ['перспектива']
природа - ['природа']
основание - ['основание']
снежный - ['снежный']
логист - ['логист']
ключевой - ['ключевой']
httpkpfuruportaldocsfdolzhnostnyeokladyppsinrspdf - ['httpkpfuruportaldocsfdolzhnostnyeokladyppsinrspdf']
стенд - ['стенд']
адрес - ['адрес']
стенокардия - ['стенокардия']
франчайзинг - ['франчайзинг']
оркестр - ['оркестр']
ii - ['ii']
ошский - ['ошский']
юнус - ['юнусов']
замысел - ['замысел']
актив - ['актив']
мониторинг - ['мониторинг']
плеханов - ['плеханов']
документально - ['документально']
рука - ['рука']
дв - ['дв']
независимый - ['независимый']
оперативно - ['оперативно']
бизнесправо - ['бизнесправо']
съезд - ['съезд']
emailifmkkpfuru - ['emailifmkkpfuru']
юриевич - ['юриевич']
подлежащее - ['подлежащее']
астма - ['астма']
раса - ['раса']
коттеджный - ['коттеджный']
доктор - ['доктор']
линия - ['линия']
оаэ - ['оаэ']
копенгаген - ['копенгаген']
жёстко - ['жёстко']
point - ['point']
психологиябиология - ['психологиябиология']
теннис - ['теннис']
рв - ['рв']
проф - ['проф']
рамный - ['рамна']
онлайнопрос - ['онлайнопрос']
сбыт - ['сбыт']
нир - ['нир']
врачитерапевт - ['врачитерапевт']
вывести - ['вывести']
билингва - ['билингва']
росгидромет - ['росгидромет']
альфабанк - ['альфабанк']
инженериятехнология - ['инженериятехнология']
нн - ['нн']
признать - ['признать']
нормативный - ['нормативный']
стипендия - ['стипендия']
очный - ['очный']
тюркология - ['тюркология']
выплата - ['выплата']
регулярно - ['регулярно']
танец - ['танец']
семьебиология - ['семьебиология']
бухгалтер - ['бухгалтер']
кк - ['кк']
бурдин - ['бурдин']
поэт - ['поэт']
jalingaкак - ['jalingaкак']
книтукать - ['книтукай']
гис - ['гис']
министр - ['министр']
закеевич - ['закеевич']
боевой - ['боевой']
каб - ['каб']
cdogeokpfuru - ['cdogeokpfuru']
оа - ['оа']
м - ['м']
благодаря - ['благодаря']
профиль - ['профиль']
ранее - ['ранее']
портал - ['портал']
летний - ['летний']
грк - ['грк']
алидти - ['алидти']
essity - ['essity']
татарстан - ['татарстан']
четвёртый - ['четвёртый']
айсылу - ['айсылу']
отказ - ['отказ']
рубеж - ['рубеж']
фгаоувпо - ['фгаоувпо']
космос - ['космос']
аптека - ['аптека']
пётр - ['пётр']
добро - ['добро']
иуэфа - ['иуэфа']
webсайт - ['webсайт']
видеотрансляция - ['видеотрансляция']
тц - ['тц']
kisskiss - ['kisskiss']
поистине - ['поистине']
фз - ['фз']
сomplex - ['сomplex']
quantum - ['quantum']
сююмбик - ['сююмбик']
nodefielddatastatus - ['nodefielddatastatus']
читать - ['читать']
февраль - ['февраль']
гволжск - ['гволжск']
зрачок - ['зрачок']
срок - ['срок']
альтшулер - ['альтшулер']
мочить - ['мочить']
микробный - ['микробный']
дii - ['дii']
инженерия - ['инженерия']
мавлют - ['мавлютов']
рада - ['рада']
юсуп - ['юсуп', 'юсупов']
имлайтнный - ['имлайтнна']
расселять - ['расселять']
бывший - ['бывший']
вп - ['вп']
магимстриум - ['магимстриум']
опытноконструкторский - ['опытноконструкторский']
портретный - ['портретный']
языкматематик - ['языкматематик']
профильнаука - ['профильнаука']
номинация - ['номинация']
прямой - ['прямой']
стимул - ['стимул']
минтруд - ['минтруд']
дөресный - ['дөресный']
фитнесзанятие - ['фитнесзанятие']
zrkkitaygmailcom - ['zrkkitaygmailcom']
qs - ['qs']
парламент - ['парламент']
challenge - ['challenge']
international - ['international']
грамматика - ['грамматика']
электроснабжение - ['электроснабжение']
кфувкадр - ['кфувкадр']
мираса - ['мираса']
ифмиб - ['ифмиб']
josef - ['josef']
оставить - ['оставить']
опытно - ['опытно']
сканкопия - ['сканкопия']
эн - ['эн']
имитация - ['имитация']
иить - ['иить']
спостипендия - ['спостипендия']
глобализция - ['глобализция']
архивный - ['архивный']
посещать - ['посещать']
декан - ['декан']
свободно - ['свободно']
кызылкурагино - ['кызылкурагино']
гуфь - ['гуфь']
сертификатаоригинал - ['сертификатаоригинал']
видеоархив - ['видеоархив']
икеле - ['икеле']
геологиякомплексный - ['геологиякомплексный']
инструктор - ['инструктор']
advancing - ['advancing']
членкорреспондент - ['членкорреспондент']
телепередача - ['телепередача']
cotkpfuru - ['cotkpfuru']
максим - ['максимов', 'максим']
телевидениецифр - ['телевидениецифров']
равилович - ['равилович']
микро - ['микро']
уна - ['уна']
преодоление - ['преодоление']
собрание - ['собрание']
борьба - ['борьба']
экспорт - ['экспорт']
дпо - ['дпо']
тон - ['тон']
ег - ['ег']
власть - ['власть']
чистополёз - ['чистополёз']
фармасинтез - ['фармасинтез']
родина - ['родина']
мсч - ['мсч']
вузовский - ['вузовский']
судья - ['судья']
насибулла - ['насибулл']
лаишевский - ['лаишевский']
гв - ['гв']
зависеть - ['зависеть']
ионенко - ['ионенко']
ревматология - ['ревматология']
урсан - ['урсан']
онлайнэкзамен - ['онлайнэкзамен']
наземный - ['наземный']
дг - ['дг']
адъюнктура - ['адъюнктура']
агросфера - ['агросфера']
рихард - ['рихард']
машина - ['машин', 'машина']
слабовидящий - ['слабовидящий']
четверг - ['четверг']
agifta - ['agifta']
линар - ['линар']
иф - ['иф']
бюджетник - ['бюджетник']
co - ['co']
работодателямотдел - ['работодателямотдел']
арбуз - ['арбузов']
teleperfomance - ['teleperfomance']
онлайн - ['онлайн']
рао - ['рао']
столовая - ['столовая']
ла - ['ла']
терапия - ['терапия']
словарятезаурус - ['словарятезаурус']
прервать - ['прервать']
другукорректор - ['другукорректор']
минмол - ['минмол']
аспирантка - ['аспирантка']
вагизович - ['вагизович']
вестись - ['вестись']
развернуть - ['развернуть']
корея - ['корея']
tvгазета - ['tvгазета']
юниум - ['юниум']
она - ['она']
моющий - ['моющий']
лев - ['лев']
композиционный - ['композиционный']
геш - ['геш']
обходиться - ['обходиться']
въехать - ['въехать']
leaders - ['leaders']
лаборатория - ['лаборатория']
костюм - ['костюм']
автономный - ['автономный']
оперативнорозыскной - ['оперативнорозыскной']
исмет - ['исмет']
станция - ['станция']
мэр - ['мэр']
днр - ['днр']
электро - ['электро']
письмо - ['письмо']
эндокринолог - ['эндокринолог']
бн - ['бн']
тггпу - ['тггпу']
сядыгерь - ['сядыгерь']
пустой - ['пустой']
кфуфилиал - ['кфуфилиал']
httpskpfuruigorkljucharov - ['httpskpfuruigorkljucharov']
гимназия - ['гимназия']
иммукимия - ['иммукимия']
инструмент - ['инструмент']
нацелить - ['нацелить']
нога - ['нога']
перезачёт - ['перезачёт']
брюхоненко - ['брюхоненко']
торрес - ['торрес']
итис - ['итис']
ресбублик - ['ресбублик']
цнтта - ['цнтта']
оообрайт - ['оообрайт']
ахо - ['ахо']
играналитик - ['играналитик']
писать - ['писать']
сафаулдиина - ['сафаулдиина']
гигиена - ['гигиена']
здравпункт - ['здравпункт']
условие - ['условие']
назад - ['назад']
выйти - ['выйти']
итак - ['итак']
шаг - ['шаг']
дважды - ['дважды']
татнефть - ['татнефть']
казахский - ['казахский']
интенсив - ['интенсив']
единствауниверситет - ['единствауниверситет']
окулист - ['окулист']
врать - ['врать']
биляловый - ['биляловый']
финансово - ['финансово']
ст - ['ст']
труба - ['труба']
стоить - ['стоить']
система - ['система']
цор - ['цор']
фгаоувыя - ['фгаоувый']
анастезиолог - ['анастезиолог']
контрольнаука - ['контрольнаука']
структура - ['структура']
обух - ['обухов']
лекция - ['лекция']
ставка - ['ставка']
group - ['group']
тур - ['тур']
муравей - ['муравьёв']
редакция - ['редакция']
призыв - ['призыв']
вырасти - ['вырасти']
эмоция - ['эмоция']
эра - ['эра']
xvii - ['xvii']
ссср - ['ссср']
умвд - ['умвд']
archaeology - ['archaeology']
nmokpfumailru - ['nmokpfumailru']
журналист - ['журналист']
иметь - ['иметь']
класс - ['класс']
обл - ['обл']
одобрить - ['одобрить']
xii - ['xii']
лицо - ['лицо']
возврат - ['возврат']
мип - ['мип']
изыскание - ['изыскание']
kseantonovakpfuru - ['kseantonovakpfuru']
департамент - ['департамент']
традиционный - ['традиционный']
афганистан - ['афганистан']
кенгуру - ['кенгуру']
татарский - ['татарский']
ир - ['ир']
монохромный - ['монохромный']
характер - ['характер']
ad - ['ad']
фридлендер - ['фридлендер']
татарстанстат - ['татарстанстат']
dobrkpfumailru - ['dobrkpfumailru']
am - ['am']
концепция - ['концепция']
candidate - ['candidate']
мулюковый - ['мулюковый']
имнилобачевскогоприказ - ['имнилобачевскогоприказ']
ответ - ['ответ']
документооборот - ['документооборот']
касаться - ['касаться']
associate - ['associate']
орган - ['орган']
рост - ['рост']
рнф - ['рнф']
реализация - ['реализация']
видеоурок - ['видеоурок']
ивмиитвмк - ['ивмиитвмк']
случай - ['случай']
хранение - ['хранение']
edukpfuru - ['edukpfuru']
динамика - ['динамика']
болтакова - ['болтакова']
перед - ['перед']
университетский - ['университетский']
кабинет - ['кабинет']
ала - ['ала']
слаженно - ['слаженно']
медицина - ['медицина']
место - ['место']
одеться - ['одеться']
василиевич - ['василиевич']
койка - ['койка']
августачетверг - ['августачетверг']
друг - ['друг']
завод - ['завод']
урал - ['урал']
овладение - ['овладение']
програмист - ['програмист']
спустя - ['спустя']
uvilldance - ['uvilldance']
dolor - ['dolor']
фио - ['фио']
завершиться - ['завершиться']
language - ['language']
мбдопустимый - ['мбдопустимый']
ра - ['ра']
передовой - ['передовой']
фирма - ['фирма']
категорийный - ['категорийный']
солдат - ['солдат']
премия - ['премия']
копияприказ - ['копияприказ']
близко - ['близко']
подать - ['подать']
магадан - ['магадан']
портик - ['портик']
тут - ['тут']
примерно - ['примерно']
сверхний - ['сверхний']
лепта - ['лепта']
httpstudentskpfuruuniversiadevillagehostelabout - ['httpstudentskpfuruuniversiadevillagehostelabout']
faqкак - ['faqкак']
дать - ['дать', 'данные']
документылицензия - ['документылицензия']
жилберт - ['жилберт']
элина - ['элина']
ухо - ['ухо']
нинбо - ['нинбо']
прека - ['прека']
itlkpfuru - ['itlkpfuru']
фас - ['фас']
заявочный - ['заявочный']
мадоу - ['мадоу']
еф - ['еф']
гчебоксары - ['гчебоксары']
актёрский - ['актёрский']
андреевнаспециалист - ['андреевнаспециалист']
конференцияхв - ['конференцияхв']
омск - ['омск']
плэнуть - ['плэнуть']
aliquip - ['aliquip']
куртенэинститут - ['куртенэинститут']
под - ['под']
srtenishevakpfuru - ['srtenishevakpfuru']
юрист - ['юрист']
form - ['form']
pmcdpokpfuru - ['pmcdpokpfuru']
электроника - ['электроника']
партнёр - ['партнёр']
н - ['н']
видеолекция - ['видеолекция']
анилин - ['анилин']
амц - ['амц']
неоновый - ['неоновый']
арт - ['арт']
ген - ['ген']
реестр - ['реестр']
поляк - ['поляков']
против - ['против']
гиляева - ['гиляева']
научно - ['научно']
вьетнам - ['вьетнам']
избежать - ['избежать']
закамский - ['закамский']
филологиярусский - ['филологиярусский']
подъёмник - ['подъёмник']
подача - ['подача']
services - ['services']
histrusyandexru - ['histrusyandexru']
санаторийпрофилактория - ['санаторийпрофилактория']
колотый - ['колотый']
предиктор - ['предиктор']
прозвучать - ['прозвучать']
бош - ['бош']
ворлдскиллс - ['ворлдскиллс']
вфск - ['вфск']
синтетик - ['синтетик']
один - ['один']
чатменеджер - ['чатменеджер']
вов - ['вов']
сгорание - ['сгорание']
утрата - ['утрата']
тахикардия - ['тахикардия']
живой - ['живой']
л - ['л']
авиаметеостанция - ['авиаметеостанция']
лаишево - ['лаишево']
улкремлёвский - ['улкремлёвский']
жалоба - ['жалоба']
объект - ['объект']
ресурс - ['ресурс']
headhunter - ['headhunter']
разумный - ['разумный']
компенсацияз - ['компенсацияз']
иэип - ['иэип']
выдача - ['выдача']
консультантовпонедельникпятница - ['консультантовпонедельникпятница']
организаторский - ['организаторский']
читаемый - ['читаемый']
резинка - ['резинка']
реквизит - ['реквизит']
трансфер - ['трансфер']
четвертьфиналист - ['четвертьфиналист']
привлекаться - ['привлекаться']
габидинович - ['габидинович']
bridge - ['bridge']
крыло - ['крыло']
русло - ['русло']
проектный - ['проектный']
макет - ['макет']
радиовещание - ['радиовещание']
платиновый - ['платиновый']
сторона - ['сторона']
серго - ['серго']
округ - ['округ']
балкыш - ['балкыш']
вшэ - ['вшэ']
трёхкратный - ['трёхкратный']
abbyy - ['abbyy']
тепло - ['тепло']
рубчас - ['рубчас']
ва - ['ва']
повестка - ['повестка']
рм - ['рм']
музеемзаповедник - ['музеемзаповедник']
детейинвалид - ['детейинвалид']
подойти - ['подойти']
instagram - ['instagram']
данныефио - ['данныефио']
промолчать - ['промолчать']
специализация - ['специализация']
kpfuru - ['kpfuru']
revolution - ['revolution']
обучать - ['обучать']
жилищнобытовый - ['жилищнобытовый']
премьерминистр - ['премьерминистр']
проблематика - ['проблематика']
опрос - ['опрос']
testdaf - ['testdaf']
парковка - ['парковка']
сх - ['сх']
музей - ['музей']
рубежемесячный - ['рубежемесячный']
факультатив - ['факультатив']
заход - ['заход']
космонавтика - ['космонавтика']
парадигма - ['парадигма']
амакс - ['амакс']
развивать - ['развивать']
алсу - ['алсу']
сельхозтехника - ['сельхозтехника']
пфр - ['пфр']
экология - ['экология']
шмель - ['шмель']
временно - ['временно']
лауреат - ['лауреат']
imaksimovaitkfuru - ['imaksimovaitkfuru']
перевод - ['перевод']
ая - ['ая']
товар - ['товар']
конкретный - ['конкретный']
репортаж - ['репортаж']
квнщикова - ['квнщиковы']
карантин - ['карантин']
расти - ['расти']
наставник - ['наставник']
принести - ['принести']
озон - ['озон']
чел - ['чел']
половина - ['половина']
директорат - ['директорат']
дамин - ['даминов']
отель - ['отель']
равенство - ['равенство']
вцтый - ['вцтый']
правило - ['правило']
х - ['х']
график - ['график']
уфа - ['уфа']
финико - ['финико']
административный - ['административный']
токсин - ['токсин']
сергеевич - ['сергеевич']
kфуквиза - ['kфуквиза']
миокард - ['миокард']
энергетика - ['энергетика']
eddy - ['eddy']
инженертехнолог - ['инженертехнолог']
тем - ['тем']
swiss - ['swiss']
нурмухамет - ['нурмухаметов']
бороться - ['бороться']
мывместе - ['мывместе']
ботаника - ['ботаника']
грозить - ['грозить']
alma - ['alma']
work - ['work']
ученик - ['ученик']
транстехсервис - ['транстехсервис']
лх - ['лх']
языкязык - ['языкязык']
значок - ['значок']
стационарный - ['стационарный']
to - ['to']
надбавка - ['надбавка']
биохимия - ['биохимия']
аспирантурецентр - ['аспирантурецентр']
эйлер - ['эйлер']
ельцин - ['ельцин']
зачёт - ['зачёт']
орп - ['орп']
people - ['people']
затрата - ['затрата']
ut - ['ut']
всеобщий - ['всеобщий']
labore - ['labore']
mir - ['mir']
срочный - ['срочный']
выделять - ['выделять']
средне - ['средне']
казна - ['казна']
process - ['process']
руслан - ['руслан']
фильтр - ['фильтр']
альфа - ['альфа']
нефть - ['нефть']
палеоэкология - ['палеоэкология']
хуснутдинов - ['хуснутдинов']
др - ['др']
кфуприказ - ['кфуприказ']
праченко - ['праченко']
включая - ['включая']
рыба - ['рыба']
ценный - ['ценный']
гинекология - ['гинекология']
вакцинация - ['вакцинация']
habirshahmailru - ['habirshahmailru']
офис - ['офис']
документовед - ['документовед']
пора - ['пора']
альметьевск - ['альметьевск']
геодезист - ['геодезист']
сетевой - ['сетевой']
курсовмагистрант - ['курсовмагистрант']
отечь - ['отёк']
антихрупкий - ['антихрупкий']
инстаграм - ['инстаграм']
юстиция - ['юстиция']
омиксный - ['омиксный']
кружкисайт - ['кружкисайт']
область - ['область']
логин - ['логин']
семья - ['семья']
задумываться - ['задумываться']
довузовский - ['довузовский']
кутуй - ['кутуй']
changellenge - ['changellenge']
менеджментitменеджмент - ['менеджментitменеджмент']
universmotri - ['universmotri']
umcmailru - ['umcmailru']
шёлковый - ['шёлковый']
cloud - ['cloud']
опыт - ['опыт']
инстранный - ['инстранный']
кроме - ['кроме']
студентыстаршеклассник - ['студентыстаршеклассник']
хрестоматия - ['хрестоматия']
телефондеканат - ['телефондеканат']
губкин - ['губкин']
emailitiskpfuru - ['emailitiskpfuru']
байгыш - ['байгыш']
emailimmkpfuru - ['emailimmkpfuru']
детиинвалид - ['детиинвалид']
iv - ['iv']
kartli - ['kartli']
вычет - ['вычет']
языковой - ['языковой']
муддарис - ['муддарис']
алчак - ['алчак']
студклуб - ['студклуб']
гюльмирзаевич - ['гюльмирзаевич']
mathematics - ['mathematics']
микроволокно - ['микроволокно']
онлайнтехнология - ['онлайнтехнология']
эфир - ['эфир']
покупать - ['покупать']
httpsvkcomkvnkfuleague - ['httpsvkcomkvnkfuleague']
правоведение - ['правоведение']
площадь - ['площадь']
доплата - ['доплата']
докторский - ['докторский']
shimadzu - ['shimadzu']
спецкурс - ['спецкурс']
сайт - ['сайт']
успешность - ['успешность']
каждый - ['каждый']
кадр - ['кадр']
иванов - ['иванов']
ночной - ['ночной']
мбоу - ['мбоу']
emailisfnkpfuru - ['emailisfnkpfuru']
идея - ['идея']
постановление - ['постановление']
нужин - ['нужин']
orgkomitetmailru - ['orgkomitetmailru']
дельта - ['дельта']
матрос - ['матрос']
лушникова - ['лушникова']
пешком - ['пешком']
канал - ['канал']
набор - ['набор']
итбизнес - ['итбизнес']
минюст - ['минюст']
абсолютный - ['абсолютный']
науковедение - ['науковедение']
успех - ['успех']
документыоб - ['документыоб']
th - ['th']
одарённый - ['одарённый']
лично - ['лично']
тестовый - ['тестовый']
штамп - ['штамп']
хасан - ['хасанов']
bars - ['bars']
laparoscopic - ['laparoscopic']
colgatepalmolive - ['colgatepalmolive']
приложениямилицензия - ['приложениямилицензия']
ankumcmailru - ['ankumcmailru']
нефтепродукт - ['нефтепродукт']
совокупный - ['совокупный']
расчётчик - ['расчётчик']
нижний - ['нижний']
профилактика - ['профилактика']
пение - ['пение']
pride - ['pride']
нур - ['нур']
проект - ['проект']
выбор - ['выбор']
оклад - ['оклад']
dpi - ['dpi']
кремлёвский - ['кремлёвский']
институтфакультет - ['институтфакультет']
оперативный - ['оперативный']
крым - ['крым']
лидерский - ['лидерский']
чуть - ['чуть']
самарканд - ['самарканд']
технохимпром - ['технохимпром']
медийный - ['медийный']
иэ - ['иэ']
гчистополь - ['гчистополь']
беседа - ['беседа']
алгоритм - ['алгоритм']
растение - ['растение']
тройка - ['тройка']
здесь - ['здесь']
сувенир - ['сувенир']
олимпиадный - ['олимпиадный']
тишина - ['тишина']
квадратный - ['квадратный']
тп - ['тп']
очки - ['очки']
implemented - ['implemented']
флоп - ['флоп']
микроканал - ['микроканал']
карьера - ['карьера']
крутушка - ['крутушка']
биоинформатика - ['биоинформатика']
мокрый - ['мокрый']
elangteachgmailcom - ['elangteachgmailcom']
через - ['через']
кфуитлицей - ['кфуитлицей']
аграрный - ['аграрный']
itлицей - ['itлицей']
серия - ['серия']
семь - ['семь']
step - ['step']
tempor - ['tempor']
садик - ['садик']
инострый - ['инострый']
фролов - ['фролов']
управление - ['управление']
масуд - ['масуд']
путёвка - ['путёвка']
httpsvkcomnastenblshka - ['httpsvkcomnastenblshka']
химик - ['химик']
тюркомусульманский - ['тюркомусульманский']
щ - ['щ']
рейтинг - ['рейтинг']
вш - ['вш']
северозападный - ['северозападный']
смех - ['смех']
астрометрия - ['астрометрия']
translation - ['translation']
вокал - ['вокал']
помогать - ['помогать']
должный - ['должный']
источник - ['источник']
азатович - ['азатович']
пм - ['пм']
гимназияинтернат - ['гимназияинтернат']
бухарский - ['бухарский']
помимо - ['помимо']
хореография - ['хореография']
картография - ['картография']
подва - ['подва']
корреспонденция - ['корреспонденция']
формат - ['формат']
закупка - ['закупка']
реалистичность - ['реалистичность']
вest - ['вest']
auditmailru - ['auditmailru']
телеканал - ['телеканал']
гудэксперт - ['гудэксперт']
препарат - ['препарат']
сжидить - ['сжидить']
хотеться - ['хотеться']
трофимука - ['трофимука']
bridges - ['bridges']
kuep - ['kuep']
рфуказ - ['рфуказ']
ч - ['ч']
лекарство - ['лекарство']
digital - ['digital']
шашка - ['шашка']
кредитфинанс - ['кредитфинанс']
ипо - ['ипо']
институт - ['институт']
минниханов - ['минниханов']
field - ['field']
животное - ['животное']
соципотека - ['соципотека']
популярный - ['популярный']
worldnese - ['worldnese']
silk - ['silk']
tema - ['tema']
бвэ - ['бвэ']
документация - ['документация']
хирург - ['хирург']
русфинанс - ['русфинанс']
участок - ['участок']
сафпласт - ['сафпласт']
баку - ['баку']
нейробиология - ['нейробиология']
шок - ['шок']
поволжский - ['поволжский']
маркетинг - ['маркетинг']
xxvi - ['xxvi']
валеев - ['валеев']
талон - ['талон']
иметься - ['иметься']
личный - ['личный']
прискорбие - ['прискорбие']
science - ['science']
специфика - ['специфика']
утратить - ['утратить']
бонус - ['бонус']
куртен - ['куртен']
бухгалтерский - ['бухгалтерский']
универсиадынаучный - ['универсиадынаучный']
ибланк - ['ибланк']
развитие - ['развитие']
север - ['север']
досуг - ['досуг']
особо - ['особо']
затем - ['затем']
институтат - ['институтат']
договор - ['договор']
артист - ['артист']
закирович - ['закирович']
башир - ['башир']
интернетприёмный - ['интернетприёмный']
лобачевскогосайт - ['лобачевскогосайт']
край - ['край']
рнц - ['рнц']
мд - ['мд']
почтас - ['почтас']
экран - ['экран']
инжиниринговый - ['инжиниринговый']
чем - ['чем']
литейный - ['литейный']
архитектор - ['архитектор']
training - ['training']
чемпион - ['чемпион']
социолог - ['социолог']
важный - ['важный']
предел - ['предел']
попасть - ['попасть']
техноарт - ['техноарт']
flatstack - ['flatstack']
секретарьпомощник - ['секретарьпомощник']
агзам - ['агзамов']
даже - ['даже']
егэрезультат - ['егэрезультат']
урология - ['урология']
лыжный - ['лыжный']
номенклатура - ['номенклатура']
туманов - ['туманов']
металл - ['металл']
жирный - ['жирный']
информация - ['информация']
мигрант - ['мигрант']
смочь - ['смочь']
iikadyrovakpfuru - ['iikadyrovakpfuru']
аша - ['аша']
сипеться - ['сипись']
сервис - ['сервис']
amet - ['amet']
pdf - ['pdf']
март - ['март']
коринфский - ['коринфский']
repeat - ['repeat']
биологически - ['биологически']
мерлен - ['мерлен']
воплощение - ['воплощение']
онлайнпрокторинг - ['онлайнпрокторинг']
полуфиналист - ['полуфиналист']
камэнергоремонт - ['камэнергоремонт']
за - ['за']
громкий - ['громкий']
dance - ['dance']
геоинформатика - ['геоинформатика']
курс - ['курс']
дело - ['дело']
tatcenter - ['tatcenter']
социология - ['социология']
гамалея - ['гамалея']
фасовщик - ['фасовщик']
ivanpetrovyandexru - ['ivanpetrovyandexru']
уровень - ['уровень']
ди - ['ди']
панорама - ['панорама']
цифра - ['цифра']
людейвыпускник - ['людейвыпускник']
нужда - ['нужда']
суета - ['суета']
бактерия - ['бактерия']
дилюс - ['дилюс']
egs - ['egs']
zoom - ['zoom']
шрифт - ['шрифт']
соловей - ['соловьёв']
гти - ['гти']
гаусый - ['гаусый']
маркетолог - ['маркетолог']
дышать - ['дышать']
какойлибо - ['какойлибо']
рядом - ['рядом']
фотомарафон - ['фотомарафон']
журавлик - ['журавлик']
arabiccentremailru - ['arabiccentremailru']
диаэма - ['диаэма']
нк - ['нк']
эффективно - ['эффективно']
сбербанк - ['сбербанк']
з - ['з']
полимеразный - ['полимеразный']
предмет - ['предмет']
зарубеж - ['зарубеж']
находчивый - ['находчивый']
европейский - ['европейский']
привет - ['привет']
поток - ['поток']
виновник - ['виновник']
студентоврекламщик - ['студентоврекламщик']
ранний - ['ранний']
ординаторамназначаться - ['ординаторамназначаться']
лилия - ['лилия']
говорить - ['говорить']
предметный - ['предметный']
два - ['два']
рафкатович - ['рафкатович']
москва - ['москва']
фронтмен - ['фронтмен']
ларец - ['ларец']
отдел - ['отдел']
договорный - ['договорный']
чакчак - ['чакчак']
кфустудент - ['кфустудент']
организовать - ['организовать']
любойполный - ['любойполный']
повеселить - ['повеселить']
тататрстан - ['тататрстан']
прокурорский - ['прокурорский']
материал - ['материал']
ну - ['ну']
резонанс - ['резонанс']
резюме - ['резюме']
концерт - ['концерт']
пласт - ['пласт']
отраслевой - ['отраслевой']
развиваться - ['развиваться']
гетеинститут - ['гетеинститут']
геномик - ['геномик']
низкий - ['низкий']
гбу - ['гбу']
хайбуллин - ['хайбуллин']
мгу - ['мгу']
начинающий - ['начинающий']
троллейбус - ['троллейбус']
еда - ['еда']
багаутдин - ['багаутдинов']
роберт - ['роберт']
lorem - ['lorem']
шараф - ['шараф']
идеология - ['идеология']
также - ['также']
спохимия - ['спохимия']
картина - ['картина']
рано - ['рано']
ирина - ['ирина']
невролог - ['невролог']
сварочный - ['сварочный']
америка - ['америка']
биологиябиохимия - ['биологиябиохимия']
гранпереть - ['гранпереть']
румия - ['румия']
биоинженерия - ['биоинженерия']
гпх - ['гпх']
ovsatoninakpfuru - ['ovsatoninakpfuru']
произвести - ['произвести']
низ - ['низам']
traffity - ['traffity']
тукаявысокий - ['тукаявысокий']
аделин - ['аделин']
кфуinstructions - ['кфуinstructions']
калинкин - ['калинкин']
дефортисдис - ['дефортисдис']
фотоотчёт - ['фотоотчёт']
аи - ['аи']
шакир - ['шакиров']
вклад - ['вклад']
отозвать - ['отозвать']
всё - ['всё']
св - ['св']
топ - ['топ']
шинный - ['шинный']
загс - ['загс']
deans - ['deans']
крайне - ['крайне']
имм - ['имм']
пятёрочка - ['пятёрочка']
заказ - ['заказ']
основа - ['основа']
ильдар - ['ильдар']
астроном - ['астроном']
планшет - ['планшет']
барс - ['барс']
технологиитехнология - ['технологиитехнология']
сб - ['сб']
авхадий - ['авхадиев']
киргизка - ['киргизка']
бэк - ['бэк']
связный - ['связный']
накануне - ['накануне']
отвод - ['отвод']
топология - ['топология']
ispeak - ['ispeak']
молодёжь - ['молодёжь']
мозг - ['мозг']
iclкпо - ['iclкпо']
бакалавриат - ['бакалавриат']
mater - ['mater']
университетепутевка - ['университетепутевка']
причина - ['причина']
меню - ['меню']
httpnicgovru - ['httpnicgovru']
скорочтение - ['скорочтение']
ивмиит - ['ивмиит']
openlab - ['openlab']
ежемесячно - ['ежемесячно']
раймановый - ['раймановый']
эразмуса - ['эразмуса']
пакет - ['пакет']
haier - ['haier']
биологиихимия - ['биологиихимия']
валентина - ['валентина']
россия - ['россия']
техсервисмосква - ['техсервисмосква']
сенин - ['сенин']
техника - ['техника']
кубок - ['кубок']
из - ['из']
стипендийгрант - ['стипендийгрант']
устать - ['устать', 'устав']
узун - ['узун']
кфуть - ['кфуть']
библиотекагазета - ['библиотекагазета']
中文 - ['中文']
гнулата - ['гнулата']
lawyer - ['lawyer']
садиться - ['садиться']
десять - ['десять']
law - ['law']
quis - ['quis']
юргпу - ['юргпу']
хх - ['хх']
булсаң - ['булсаң']
engineering - ['engineering']
вода - ['вода']
cdoksugmailcom - ['cdoksugmailcom']
якоби - ['якоби']
стаж - ['стаж']
единство - ['единство']
техникгеолог - ['техникгеолог']
обсерватория - ['обсерватория']
белорусь - ['белорусь']
еив - ['еив']
овьедо - ['овьедо']
квартал - ['квартал']
гибадулин - ['гибадулин']
ип - ['ип']
нид - ['нид']
детство - ['детство']
код - ['код']
lingvohack - ['lingvohack']
битум - ['битум']
субъект - ['субъект']
nodefielddatatype - ['nodefielddatatype']
роаг - ['роаг']
магдеев - ['магдеев']
incididunt - ['incididunt']
либо - ['либо']
абонемент - ['абонемент']
век - ['век']
нетка - ['нетка']
вспышка - ['вспышка']
гнчелны - ['гнчелны']
зп - ['зп']
kafistefkfumailru - ['kafistefkfumailru']
саттар - ['саттаров']
площадка - ['площадка']
онлайнкурс - ['онлайнкурс']
присутствие - ['присутствие']
документылист - ['документылист']
минифутбол - ['минифутбол']
плановый - ['плановый']
икн - ['икн']
экспортный - ['экспортный']
заявка - ['заявка']
студенчество - ['студенчество']
статья - ['статья']
регенерация - ['регенерация']
nsfc - ['nsfc']
межъязыковой - ['межъязыковой']
мрп - ['мрп']
стандартизация - ['стандартизация']
чернобелый - ['чернобелый']
иран - ['иран']
фотобанк - ['фотобанк']
конвенция - ['конвенция']
вэд - ['вэд']
структурный - ['структурный']
рфпередовой - ['рфпередовой']
райффайзенбанк - ['райффайзенбанк']
лекциимарт - ['лекциимарт']
ярмакеев - ['ярмакеев']
опасный - ['опасный']
лингвокультурология - ['лингвокультурология']
covid - ['covid']
тренд - ['тренд']
гафият - ['гафиятов']
игоревич - ['игоревич']
карточка - ['карточка']
наградить - ['наградить']
мотвационный - ['мотвационный']
острота - ['острота']
kazan - ['kazan']
вчера - ['вчера']
доцент - ['доцент']
кукморский - ['кукморский']
люция - ['люция']
посол - ['посол']
флюзович - ['флюзович']
teamsинструкция - ['teamsинструкция']
речь - ['речь']
здание - ['здание']
вести - ['вести']
редис - ['редис']
химикэксперт - ['химикэксперт']
зад - ['зад']
httpsbusinessfacebookcomklyucharovirefyourpages - ['httpsbusinessfacebookcomklyucharovirefyourpages']
объявить - ['объявить']
шишка - ['шишка']
история - ['история']
клуб - ['клуб']
source - ['source']
варфоломеев - ['варфоломеев']
платаот - ['платаот']
поезд - ['поезд']
мастерство - ['мастерство']
кыз - ['кыз']
р - ['р']
каләм - ['каләм']
библиограф - ['библиограф']
тренер - ['тренер']
палеонтология - ['палеонтология']
forum - ['forum']
оценивать - ['оценивать']
наиболее - ['наиболее']
нос - ['нос']
монография - ['монография']
юрфак - ['юрфак']
флюорография - ['флюорография']
овощ - ['овощ']
эйдос - ['эйдос']
жэнь - ['жэнь']
growth - ['growth']
официант - ['официант']
турецкий - ['турецкий']
дизайн - ['дизайн']
рекреация - ['рекреация']
вначале - ['вначале']
master - ['master']
физиотерапия - ['физиотерапия']
st - ['st']
помощник - ['помощник']
еадоговор - ['еадоговор']
пропуск - ['пропуск']
нечирваный - ['нечирваный']
биомедицинк - ['биомедицинка']
турфирма - ['турфирма']
vucaмиро - ['vucaмиро']
путь - ['путь']
далёкий - ['далёкий']
вправе - ['вправе']
элита - ['элита']
повторно - ['повторно']
вводиться - ['вводиться']
нортгаз - ['нортгаз']
организацииматематика - ['организацииматематика']
дойти - ['дойти']
оргкомитет - ['оргкомитет']
шайхелислам - ['шайхелислам']
сподиплом - ['сподиплом']
магид - ['магид']
ближний - ['ближний']
mobile - ['mobile']
взлом - ['взлом']
изучать - ['изучать']
дс - ['дс']
фрик - ['фрик']
центраинженерный - ['центраинженерный']
устроиться - ['устроиться']
диссертацийстудент - ['диссертацийстудент']
конкурс - ['конкурс']
геолог - ['геолог']
презентациядний - ['презентациядний']
consequat - ['consequat']
дисциплиныуважать - ['дисциплиныуважать']
наукия - ['наукия']
биологопочвенный - ['биологопочвенный']
интернационализация - ['интернационализация']
перец - ['перец']
фс - ['фс']
споинформатика - ['споинформатика']
признание - ['признание']
кфус - ['кфус']
школа - ['школа']
берсут - ['берсут']
защитить - ['защитить']
тема - ['тема']
lifestyle - ['lifestyle']
аллергология - ['аллергология']
оно - ['оно']
базис - ['базис']
deutsche - ['deutsche']
поликультурный - ['поликультурный']
одновременно - ['одновременно']
anistatmailru - ['anistatmailru']
киям - ['киямов']
совкомбанк - ['совкомбанк']
чёткий - ['чёткий']
лицомнаправляться - ['лицомнаправляться']
литературный - ['литературный']
материальный - ['материальный']
ксения - ['ксения']
континент - ['континент']
инсталайф - ['инсталайф']
заглавие - ['заглавие']
рафикович - ['рафикович']
джемстарый - ['джемстарый']
криалэнергострой - ['криалэнергострой']
внести - ['внести']
помочьтелефон - ['помочьтелефон']
дверной - ['дверной']
щелкуновый - ['щелкуновый']
бадминтон - ['бадминтон']
сош - ['сош']
ничего - ['ничего']
державин - ['державин']
купить - ['купить']
лагерь - ['лагерь']
наш - ['наш']
оксана - ['оксана']
учесть - ['учесть']
перечень - ['перечень']
цитология - ['цитология']
событие - ['событие']
дрбиблиотека - ['дрбиблиотека']
лимфедёма - ['лимфедёма']
эв - ['эв']
гум - ['гум']
крупномасштабный - ['крупномасштабный']
генә - ['генә']
менее - ['менее']
tikkurila - ['tikkurila']
новичок - ['новичок']
ветеран - ['ветеран']
девять - ['девять']
несмотря - ['несмотря']
постановка - ['постановка']
гарантия - ['гарантия']
лобачевский - ['лобачевский']
кфуорганизация - ['кфуорганизация']
гамковидвак - ['гамковидвак']
дислексия - ['дислексия']
игра - ['игра']
многое - ['многое']
чт - ['чт']
гармония - ['гармония']
спорт - ['спорт']
домой - ['домой']
прикладной - ['прикладной']
профит - ['профит']
практикедоговор - ['практикедоговор']
споматематикафизикабиологияхимиягеографияинформатика - ['споматематикафизикабиологияхимиягеографияинформатика']
германский - ['германский']
иннополис - ['иннополис']
тбдоговор - ['тбдоговор']
илина - ['илина']
httpsключароврф - ['httpsключароврф']
почему - ['почему']
начислить - ['начислить']
зал - ['зал']
нчелны - ['нчелны']
files - ['files']
studio - ['studio']
ископаемое - ['ископаемое']
лингвистикатеория - ['лингвистикатеория']
выделить - ['выделить']
culture - ['culture']
унификация - ['унификация']
роботыпациент - ['роботыпациент']
analysis - ['analysis']
компетенция - ['компетенция']
комплект - ['комплект']
биомедицинский - ['биомедицинский']
аксёнов - ['аксёнов']
адресказань - ['адресказань']
my - ['my']
гриб - ['гриб']
oriflame - ['oriflame']
darelfonyn - ['darelfonyn']
одержать - ['одержать']
партнеръ - ['партнеръ']
рукипитание - ['рукипитание']
кредитный - ['кредитный']
пищевой - ['пищевой']
придать - ['придать']
валиев - ['валиев']
докупать - ['докупать']
проблема - ['проблема']
историярусский - ['историярусский']
согаз - ['согаз']
тч - ['тч']
производство - ['производство']
стабилизация - ['стабилизация']
фгб - ['фгб']
аделить - ['аделить']
черноморский - ['черноморский']
яруллина - ['яруллина']
moodle - ['moodle']
эксректор - ['эксректор']
публикация - ['публикация']
бакалавриатспециалитет - ['бакалавриатспециалитет']
хачатурян - ['хачатурян']
ортодонтия - ['ортодонтия']
факс - ['факс']
широкий - ['широкий']
кордон - ['кордон']
подарить - ['подарить']
двс - ['двс']
химиябиология - ['химиябиология']
психолог - ['психолог']
стелла - ['стелла']
брюссель - ['брюссель']
резервный - ['резервный']
счастие - ['счастие']
знание - ['знание']
яо - ['яо']
индустрия - ['индустрия']
priemkpfuru - ['priemkpfuru']
дочерний - ['дочерний']
романогерманский - ['романогерманский']
колесо - ['колесо']
сюда - ['сюда']
гтюмень - ['гтюмень']
заочный - ['заочный']
teleperformance - ['teleperformance']
печать - ['печать']
httpswwwfacebookcomigorklyucharov - ['httpswwwfacebookcomigorklyucharov']
рукопись - ['рукопись']
доп - ['доп']
специаист - ['специаист']
япония - ['япония']
институтамарт - ['институтамарт']
кулибин - ['кулибин']
впрочем - ['впрочем']
композитор - ['композитор']
cube - ['cube']
интернеттур - ['интернеттур']
рияз - ['рияз']
радиоспектроскопия - ['радиоспектроскопия']
дипломатия - ['дипломатия']
секретарьрябинин - ['секретарьрябинин']
шмидт - ['шмидт']
ренада - ['ренада']
отряд - ['отряд']
эвм - ['эвм']
гиниятуллин - ['гиниятуллин']
реинжиниринг - ['реинжиниринг']
экзогенный - ['экзогенный']
комитет - ['комитет']
es - ['es']
отход - ['отход']
алишев - ['алишев']
вымышленный - ['вымышленный']
озёрный - ['озёрный']
emailchelnykpfuru - ['emailchelnykpfuru']
корпоративный - ['корпоративный']
ifme - ['ifme']
бал - ['бал']
задавать - ['задавать']
вечер - ['вечер']
рособрнадзор - ['рособрнадзор']
любой - ['любой']
web - ['web']
кристофер - ['кристофер']
топовый - ['топовый']
türkçe - ['türkçe']
третий - ['третий']
хайрутдин - ['хайрутдинов']
айскарго - ['айскарго']
россельхозбанк - ['россельхозбанк']
есть - ['есть']
кафедра - ['кафедра']
нии - ['нии']
ефимович - ['ефимович']
писаться - ['писаться']
приз - ['приз']
studpolikmailru - ['studpolikmailru']
инна - ['инна']
ма - ['ма']
мегаполис - ['мегаполис']
httpskpfuruportaldocsfoformlenieizaseleniestazherovipodfakapdf - ['httpskpfuruportaldocsfoformlenieizaseleniestazherovipodfakapdf']
секретать - ['секретать']
пища - ['пища']
value - ['value']
пройти - ['пройти']
снабжение - ['снабжение']
поведение - ['поведение']
награда - ['награда']
среднеe - ['среднеe']
ионный - ['ионный']
преддипломнаятема - ['преддипломнаятема']
күңелсезлька - ['күңелсезлька']
лия - ['лия']
семикратное - ['семикратное']
эльвира - ['эльвира']
исмаев - ['исмаев']
зачётка - ['зачётка']
культура - ['культура']
поздно - ['поздно']
конверсия - ['конверсия']
художник - ['художник']
систематически - ['систематически']
нил - ['нил']
куда - ['куда']
думать - ['думать']
вслед - ['вслед']
комплекс - ['комплекс']
список - ['список']
httpskpfurualumnuskomsomolskayadruzhbaetokruglosutochnoinahtml - ['httpskpfurualumnuskomsomolskayadruzhbaetokruglosutochnoinahtml']
психологияпсихотерапия - ['психологияпсихотерапия']
флагман - ['флагман']
природоресурсный - ['природоресурсный']
её - ['её']
чистополь - ['чистополь']
активность - ['активность']
qrкод - ['qrкод']
ольга - ['ольга']
вассерман - ['вассерман']
взять - ['взять']
медсестра - ['медсестра']
alizamalievakpfuru - ['alizamalievakpfuru']
дьяконов - ['дьяконов']
course - ['course']
word - ['word']
интересовать - ['интересовать']
юноша - ['юноша']
шараева - ['шараева']
дарить - ['дарить']
миателана - ['миателана']
рффи - ['рффи']
отношениявостка - ['отношениявостка']
зав - ['зав']
инвестиция - ['инвестиция']
сюжетный - ['сюжетный']
разряд - ['разряд']
премьера - ['премьера']
cекретарькоординатор - ['cекретарькоординатор']
атэс - ['атэс']
майфестиваль - ['майфестиваль']
ек - ['ек']
рш - ['рш']
испытать - ['испытать']
вестник - ['вестник']
записаться - ['записаться']
ремонт - ['ремонт']
унивесритет - ['унивесритет']
азам - ['азам']
кардиохирургия - ['кардиохирургия']
специалистгеофизика - ['специалистгеофизика']
колебаться - ['колебаться']
осмотр - ['осмотр']
завести - ['завести']
медицинский - ['медицинский']
учителейпредметник - ['учителейпредметник']
ано - ['ано']
вред - ['вред']
узкий - ['узкий']
южный - ['южный']
онлайнформат - ['онлайнформат']
служба - ['служба']
гистероскопия - ['гистероскопия']
генерация - ['генерация']
аудитория - ['аудитория']
цикл - ['цикл']
метеообсерватория - ['метеообсерватория']
мы - ['мы']
коллектив - ['коллектив']
элемент - ['элемент']
путём - ['путём']
нф - ['нф']
hrслужба - ['hrслужба']
законаправить - ['законаправить']
тензор - ['тензор']
этнопедагогика - ['этнопедагогика']
тн - ['тн']
масса - ['масса']
фстэк - ['фстэк']
университетсистема - ['университетсистема']
допустить - ['допустить']
писарев - ['писарев']
выслуга - ['выслуга']
стоматология - ['стоматология']
супругасупругий - ['супругасупругий']
подвести - ['подвести']
магазин - ['магазин']
python - ['python']
софт - ['софт']
intelligence - ['intelligence']
почта - ['почта']
газ - ['газ']
чин - ['чин']
почётный - ['почётный']
триумф - ['триумф']
оба - ['оба']
ноябрьск - ['ноябрьск']
оттолкнуть - ['оттолкнуть']
организатор - ['организатор']
гделибо - ['гделибо']
рн - ['рн']
услугилица - ['услугилица']
турнир - ['турнир']
девиз - ['девиз']
ахметович - ['ахметович']
анилинокрасочный - ['анилинокрасочный']
xxii - ['xxii']
racoons - ['racoons']
поездка - ['поездка']
филологиятекстовый - ['филологиятекстовый']
аттестат - ['аттестат']
marksteam - ['marksteam']
ивмитя - ['ивмить']
радиомарт - ['радиомарт']
патент - ['патент']
контраст - ['контраст']
глобализация - ['глобализация']
hr - ['hr']
бенитёс - ['бенитёс']
нпо - ['нпо']
прибыть - ['прибыть']
energy - ['energy']
twitter - ['twitter']
marx - ['marx']
психологтренер - ['психологтренер']
аспирантовстипендия - ['аспирантовстипендия']
служить - ['служить']
русь - ['русь']
logistics - ['logistics']
ул - ['ул']
бо - ['бо']
менеджмент - ['менеджмент']
рекреационный - ['рекреационный']
целевика - ['целевика']
вгтимиряс - ['вгтимирясов']
занятость - ['занятость']
анастасия - ['анастасия']
envirtue - ['envirtue']
микроорганизм - ['микроорганизм']
туриловый - ['туриловый']
начисление - ['начисление']
заботиться - ['заботиться']
показ - ['показ']
нг - ['нг']
хоровод - ['хоровод']
организацияхв - ['организацияхв']
организация - ['организация']
наноэлектроника - ['наноэлектроника']
нижнекамск - ['нижнекамск']
махмут - ['махмутов']
биологияхимия - ['биологияхимия']
вз - ['вз']
археология - ['археология']
металлургия - ['металлургия']
мкк - ['мкк']
но - ['но']
сг - ['сг']
заречье - ['заречье']
гидрогеология - ['гидрогеология']
каурый - ['каурый']
рубль - ['рубль']
театр - ['театр']
ук - ['ук']
httpskpfuruportaldocsfoformlenieizaseleniepervokursnikovpdf - ['httpskpfuruportaldocsfoformlenieizaseleniepervokursnikovpdf']
гаранин - ['гаранин']
душевный - ['душевный']
след - ['след']
режиссеромпостановщик - ['режиссеромпостановщик']
при - ['при']
николай - ['николай']
лднр - ['лднр']
здравоохранениеуниверситет - ['здравоохранениеуниверситет']
таттелек - ['таттелек']
языкеоригинал - ['языкеоригинал']
пцртест - ['пцртест']
сафаротель - ['сафаротель']
выделяться - ['выделяться']
чистый - ['чистый']
зачем - ['зачем']
старостат - ['старостат']
стиль - ['стиль']
abiturientkpfuru - ['abiturientkpfuru']
логопед - ['логопед']
копирайтер - ['копирайтер']
философский - ['философский']
донецкий - ['донецкий']
графикгибкий - ['графикгибкий']
климатически - ['климатически']
урок - ['урок']
онлайнмобилизация - ['онлайнмобилизация']
llsabitovkpfuru - ['llsabitovkpfuru']
маляр - ['маляр']
sport - ['sport']
денмухамет - ['денмухаметов']
разный - ['разный']
поле - ['поле']
webдизайн - ['webдизайн']
спонсорский - ['спонсорский']
контрастный - ['контрастный']
электрокомплект - ['электрокомплект']
день - ['день']
или - ['или']
рябов - ['рябов']
хазар - ['хазар']
грамота - ['грамота']
татагропромпроект - ['татагропромпроект']
пятибалльный - ['пятибалльный']
стройматериал - ['стройматериал']
институтахна - ['институтахна']
диплом - ['диплом']
далеелицензия - ['далеелицензия']
клаус - ['клаус']
гостиница - ['гостиница']
однократно - ['однократно']
трофей - ['трофей']
ильфаровный - ['ильфаровный']
андреевич - ['андреевич']
двести - ['двести']
нирнаука - ['нирнаука']
шатёр - ['шатёр']
сырьё - ['сырьё']
регионалистик - ['регионалистик']
студентысоциолог - ['студентысоциолог']
онлайнсеминар - ['онлайнсеминар']
полис - ['полис']
заложить - ['заложить']
дружинин - ['дружинин']
способ - ['способ']
олег - ['олег']
txt - ['txt']
неоднородный - ['неоднородный']
младший - ['младший']
анестезиологияреаниматология - ['анестезиологияреаниматология']
традиция - ['традиция']
горло - ['горло']
языкекопия - ['языкекопия']
стоять - ['стоять']
гулянка - ['гулянка']
itкомпания - ['itкомпания']
хирургия - ['хирургия']
and - ['and']
внутри - ['внутри']
доверие - ['доверие']
привлекать - ['привлекать']
карла - ['карла']
прилагать - ['прилагать']
пульс - ['пульс']
весна - ['весна']
ж - ['ж']
тнв - ['тнв']
найти - ['найти']
литертур - ['литертур']
мышление - ['мышление']
позк - ['позк']
нетрадиционный - ['нетрадиционный']
психосоматика - ['психосоматика']
инструктажареестр - ['инструктажареестр']
желаемый - ['желаемый']
itробототехника - ['itробототехника']
вахитовский - ['вахитовский']
устье - ['устье']
дистанционно - ['дистанционно']
снимать - ['снимать']
экономика - ['экономика']
javascript - ['javascript']
алый - ['алый']
дфмн - ['дфмн']
шанхай - ['шанхай']
традиционно - ['традиционно']
компенсация - ['компенсация']
контрактник - ['контрактник']
ощутить - ['ощутить']
павлович - ['павлович']
метеорология - ['метеорология']
житель - ['житель']
лагер - ['лагер']
denver - ['denver']
между - ['между']
раис - ['раис']
презентация - ['презентация']
даньян - ['даньян']
пароль - ['пароль']
минисад - ['минисад']
like - ['like']
дипломный - ['дипломный']
супруг - ['супруг']
вшгма - ['вшгма']
акт - ['акт']
рб - ['рб']
салахов - ['салахов']
менеджераналитик - ['менеджераналитика']
креативный - ['креативный']
досье - ['досье']
теологияисламский - ['теологияисламский']
короткий - ['короткий']
занятиерепетиция - ['занятиерепетиция']
ошибка - ['ошибка']
цивилизация - ['цивилизация']
автоматика - ['автоматика']
algebra - ['algebra']
ппс - ['ппс']
биомеханика - ['биомеханика']
россиянин - ['россиянин']
ом - ['ом']
майкомплекс - ['майкомплекс']
платный - ['платный']
вебинар - ['вебинар']
татаристика - ['татаристика']
лист - ['лист']
cam - ['cam']
будний - ['будний']
психокоррекция - ['психокоррекция']
ит - ['ит']
itiskfu - ['itiskfu']
рамиль - ['рамиль']
sit - ['sit']
әйткәндә - ['әйткәндә']
историяархеологиявсеобщать - ['историяархеологиявсеобщать']
воспитанник - ['воспитанник']
здравоохранение - ['здравоохранение']
яз - ['яз']
учкорпус - ['учкорпус']
проверка - ['проверка']
вечно - ['вечно']
робототехника - ['робототехника']
выборы - ['выборы']
халыко - ['халыко']
окладпремия - ['окладпремия']
emailphysdepkpfuru - ['emailphysdepkpfuru']
ритейлматематика - ['ритейлматематика']
й - ['й']
эндоскопия - ['эндоскопия']
курсаименной - ['курсаименной']
впо - ['впо']
паспорт - ['паспорт']
камвтора - ['камвтора']
легализация - ['легализация']
улучшить - ['улучшить']
ребята - ['ребята']
c - ['c']
рамка - ['рамка']
основной - ['основной']
вокзал - ['вокзал']
православный - ['православный']
такташ - ['такташ']
viii - ['viii']
итогма - ['итогма']
глама - ['глама']
помощь - ['помощь']
обслужить - ['обслужа']
тандем - ['тандем']
вакантный - ['вакантный']
operator - ['operator']
акад - ['акад']
актуальный - ['актуальный']
геоповолжье - ['геоповолжье']
перейти - ['перейти']
удалить - ['удалить']
чиновник - ['чиновник']
духовный - ['духовный']
inside - ['inside']
системный - ['системный']
галлямович - ['галлямович']
батуевич - ['батуевич']
доехать - ['доехать']
gdc - ['gdc']
вопрос - ['вопрос']
кузина - ['кузина']
балл - ['балл']
миргазиз - ['миргазизов']
информатикафизика - ['информатикафизика']
оцифровщик - ['оцифровщик']
трейдераналитик - ['трейдераналитика']
вывод - ['вывод']
вступить - ['вступить']
багаж - ['багаж']
купальник - ['купальник']
биология - ['биология']
продюсер - ['продюсер']
министерство - ['министерство']
ущерб - ['ущерб']
zentrumdeyahoode - ['zentrumdeyahoode']
основать - ['основать']
ли - ['ли']
лр - ['лр']
oilfield - ['oilfield']
пробный - ['пробный']
дизайндизайн - ['дизайндизайн']
outlook - ['outlook']
о - ['о']
тенишев - ['тенишев']
тарих - ['тарих']
фотография - ['фотография']
африка - ['африка']
победить - ['победить']
mariavasilyevakpfuru - ['mariavasilyevakpfuru']
экзаменатор - ['экзаменатор']
һәм - ['һәм']
вконтакте - ['вконтакте']
трак - ['трак']
такой - ['такой']
математикаанализ - ['математикаанализ']
полный - ['полный']
ещё - ['ещё']
левобулачный - ['левобулачный']
технологийнаш - ['технологийнаш']
корпус - ['корпус']
ходить - ['ходить']
струйчатый - ['струйчатый']
свияжск - ['свияжск']
делоразработка - ['делоразработка']
управлять - ['управлять']
мастер - ['мастер']
менеджерстажёр - ['менеджерстажёр']
елабужский - ['елабужский']
edutech - ['edutech']
метиз - ['метиз']
гл - ['гл']
сабир - ['сабиров']
конкурсный - ['конкурсный']
кижть - ['кижть']
де - ['де']
тольятти - ['тольятти']
казахстан - ['казахстан']
russia - ['russia']
автобус - ['автобус']
егрюла - ['егрюла']
сбербанктехнология - ['сбербанктехнология']
хотея - ['хотея']
спо - ['спо']
эколог - ['эколог']
стипендиат - ['стипендиат']
парин - ['парин']
сурдопереводчик - ['сурдопереводчик']
экономикамеждународный - ['экономикамеждународный']
романович - ['романович']
laboris - ['laboris']
организацийпартнёр - ['организацийпартнер']
да - ['да']
заочн - ['заочн']
арабский - ['арабский']
наиля - ['наиля']
antonmailru - ['antonmailru']
menu - ['menu']
неразрывно - ['неразрывно']
выноситься - ['выноситься']
после - ['после']
мдр - ['мдр']
татарча - ['татарча']
лидер - ['лидер']
близкий - ['близкий']
вступать - ['вступать']
без - ['без']
уборщик - ['уборщик']
педантичный - ['педантичный']
оригинал - ['оригинал']
стих - ['стих']
zumba - ['zumba']
англиский - ['англиский']
jpeg - ['jpeg']
директ - ['директ']
плазма - ['плазма']
литература - ['литература']
капо - ['капо']
второе - ['второе']
звёздный - ['звёздный']
стол - ['стол']
инструктаж - ['инструктаж']
десятилетие - ['десятилетие']
ус - ['ус']
частица - ['частица']
интервьюер - ['интервьюер']
где - ['где']
үткәич - ['үткәич']
врачомтерапевт - ['врачомтерапевт']
валерий - ['валерий']
аллея - ['аллея']
pro - ['pro']
горький - ['горький']
тектовыя - ['тектовыя']
нация - ['нация']
характеристика - ['характеристика']
сайдашевазд - ['сайдашевазд']
дн - ['дн']
экспозиция - ['экспозиция']
safiamailru - ['safiamailru']
алтынбанк - ['алтынбанк']
претендовать - ['претендовать']
fest - ['fest']
ашрап - ['ашрапов']
кфуноябрьуниверситетский - ['кфуноябрьуниверситетский']
яркий - ['яркий']
consectetur - ['consectetur']
зажим - ['зажим']
секретарьхасан - ['секретарьхасанов']
кампания - ['кампания']
class - ['class']
аромат - ['аромат']
v - ['v']
протонный - ['протонный']
запись - ['запись']
обстановка - ['обстановка']
легенда - ['легенда']
рота - ['рота']
донорство - ['донорство']
имвитя - ['имвить']
стратиграфия - ['стратиграфия']
лектор - ['лектор']
суметь - ['суметь']
просто - ['просто']
esge - ['esge']
мк - ['мк']
радуга - ['радуга']
рк - ['рк']
гб - ['гб']
аспирантура - ['аспирантура']
ломоносов - ['ломоносов']
неординарный - ['неординарный']
анаит - ['анаит']
мочь - ['мочь']
sales - ['sales']
edukpfuruответ - ['edukpfuruответ']
утверждаться - ['утверждаться']
актуально - ['актуально']
бодуэн - ['бодуэн']
классно - ['классно']
мес - ['мес']
рутений - ['рутений']
конференциямть - ['конференциямть']
сенсорный - ['сенсорный']
нл - ['нл']
альбина - ['альбина']
гордость - ['гордость']
хор - ['хор']
тахтар - ['тахтаров']
габдулла - ['габдулла']
потенциал - ['потенциал']
метро - ['метро']
гказань - ['гказань']
жилищный - ['жилищный']
инженерхимик - ['инженерхимик']
максимум - ['максимум']
вектор - ['вектор']
делотехнология - ['делотехнология']
билет - ['билет']
needspeak - ['needspeak']
гузэль - ['гузэль']
фанисовнаспециалист - ['фанисовнаспециалист']
multilingual - ['multilingual']
маркс - ['маркс']
ро - ['ро']
tv - ['tv']
natalyaboltakovakpfuru - ['natalyaboltakovakpfuru']
медиапространство - ['медиапространство']
методист - ['методист']
уберечь - ['уберечь']
австрия - ['австрия']
медиакоммуникация - ['медиакоммуникация']
кул - ['кул']
рна - ['рна']
httpsmoyastranaru - ['httpsmoyastranaru']
ултоварищеский - ['ултоварищеский']
замалетдин - ['замалетдин']
ссылка - ['ссылка']
нарышкин - ['нарышкин']
caliullinalistru - ['caliullinalistru']
процедура - ['процедура']
максвелл - ['максвелл']
биоэкология - ['биоэкология']
копылов - ['копылов']
veeam - ['veeam']
конкурсант - ['конкурсант']
империология - ['империология']
зинина - ['зинина']
свой - ['свой']
экстремизм - ['экстремизм']
english - ['english']
столица - ['столица']
суд - ['суд']
russian - ['russian']
допустимый - ['допустимый']
конкурсконференция - ['конкурсконференция']
байтик - ['байтик']
бережливый - ['бережливый']
кристаллхолод - ['кристаллхолод']
мехмат - ['мехмат']
фбуз - ['фбуз']
телескоп - ['телескоп']
бизнес - ['бизнес']
рубповышенный - ['рубповышенный']
биржа - ['биржа']
хемоинформатика - ['хемоинформатика']
логистика - ['логистика']
юг - ['юг']
четыре - ['четыре']
электромобиль - ['электромобиль']
nlrpсигналинг - ['nlrpсигналинг']
ростодосааф - ['ростодосааф']
владение - ['владение']
кл - ['кл']
хузура - ['хузура']
сиа - ['сиа']
документовприказ - ['документовприказ']
аналитик - ['аналитик']
врач - ['врач']
century - ['century']
гиа - ['гиа']
системыквантовый - ['системыквантовый']
резидент - ['резидент']
пашкуров - ['пашкуров']
фч - ['фч']
тренинг - ['тренинг']
уза - ['уза']
победитель - ['победитель']
миндыгалиевич - ['миндыгалиевич']
veniam - ['veniam']
небесный - ['небесный']
прийти - ['прийти']
меняться - ['меняться']
горизонт - ['горизонт']
яхвар - ['яхвар']
профсоюз - ['профсоюз']
до - ['до']
аналить - ['аналить']
потатарски - ['потатарски']
эйткома - ['эйткома']
сша - ['сша']
вводить - ['вводить']
салих - ['салих']
такснуть - ['такснуть']
опция - ['опция']
инженерный - ['инженерный']
бти - ['бти']
рарус - ['рарус']
эрикан - ['эрикан']
метаболит - ['метаболит']
птфк - ['птфк']
работа - ['работа']
ленар - ['ленар']
превосходство - ['превосходство']
кбэр - ['кбэр']
выезд - ['выезд']
тукать - ['тукать']
превышать - ['превышать']
регламент - ['регламент']
шт - ['шт']
студентапрактикант - ['студентапрактикант']
низкотоксичный - ['низкотоксичный']
конструктивный - ['конструктивный']
языкомга - ['языкомга']
приход - ['приход']
землеустройный - ['землеустройный']
статистика - ['статистика']
ф - ['ф']
химия - ['химия']
интернат - ['интернат']
кампус - ['кампус']
пушкин - ['пушкин']
profi - ['profi']
законный - ['законный']
ансамбль - ['ансамбль']
эфко - ['эфко']
дерматовенеролог - ['дерматовенеролог']
фарси - ['фарси']
отчёт - ['отчёт']
б - ['б']
толстой - ['толстой']
библиотекарь - ['библиотекарь']
оргсобрание - ['оргсобрание']
посёлок - ['посёлок']
cast - ['cast']
миф - ['миф']
company - ['company']
перевестись - ['перевестись']
чтоть - ['чтоть']
грамотно - ['грамотно']
подбор - ['подбор']
de - ['de']
festival - ['festival']
пао - ['пао']
emailaspirantotdelkpfuru - ['emailaspirantotdelkpfuru']
слава - ['слава']
прокурор - ['прокурор']
беларусь - ['беларусь']
совокупность - ['совокупность']
please - ['please']
продактс - ['продактс']
радио - ['радио']
квалификация - ['квалификация']
пл - ['пл']
президент - ['президент']
форум - ['форум']
мбдоу - ['мбдоу']
аппарат - ['аппарат']
коучинга - ['коучинга']
техподдержка - ['техподдержка']
дисциплинарный - ['дисциплинарный']
явка - ['явка']
n - ['n']
pricewaterhousecoopers - ['pricewaterhousecoopers']
аналитика - ['аналитика']
юбилей - ['юбилей']
поесть - ['поесть']
первоначально - ['первоначально']
компьютер - ['компьютер']
фото - ['фото']
httpsliftbfrunastavnik - ['httpsliftbfrunastavnik']
контракт - ['контракт']
можно - ['можно']
et - ['et']
кинолог - ['кинолог']
штраф - ['штраф']
креатив - ['креатив']
аудит - ['аудит']
power - ['power']
потому - ['потому']
politbkru - ['politbkru']
картлить - ['картлить']
даян - ['даян']
биоразнообразие - ['биоразнообразие']
принцип - ['принцип']
соискание - ['соискание']
филология - ['филология']
цепь - ['цепь']
ресурсосбережение - ['ресурсосбережение']
весёлый - ['весёлый']
consulting - ['consulting']
транспорт - ['транспорт']
жидкость - ['жидкость']
вещество - ['вещество']
инженерпрограммист - ['инженерпрограммист']
бухара - ['бухара']
ортопедия - ['ортопедия']
инспектор - ['инспектор']
аудитор - ['аудитор']
межлаука - ['межлаук']
кск - ['кск']
времяместоконсультантконтакт - ['времяместоконсультантконтакт']
очень - ['очень']
business - ['business']
юмор - ['юмор']
ипользование - ['ипользование']
оренбургский - ['оренбургский']
ждать - ['ждать']
иня - ['иней']
production - ['production']
итискурс - ['итискурс']
авиаметтелек - ['авиаметтелек']
таюрский - ['таюрский']
генконсул - ['генконсул']
департаментасовместно - ['департаментасовместно']
мифтахутдинов - ['мифтахутдинов']
зодчий - ['зодчий']
eiusmod - ['eiusmod']
сс - ['сс']
город - ['город']
инвест - ['инвест']
опечатка - ['опечатка']
мифтахов - ['мифтахов']
элитарный - ['элитарный']
имим - ['имим']
география - ['география']
архивист - ['архивист']
этнология - ['этнология']
адгамович - ['адгамович']
гбуз - ['гбуз']
инга - ['инга']
гость - ['гость']
httpswwwktrtseminarscom - ['httpswwwktrtseminarscom']
sed - ['sed']
идентификатор - ['идентификатор']
distance - ['distance']
африкаанс - ['африкаанс']
стажёр - ['стажёр']
полезный - ['полезный']
машинный - ['машинный']
казань - ['казань']
робот - ['робот']
медиаэкскурсия - ['медиаэкскурсия']
фнс - ['фнс']
ош - ['ош', 'оша']
скорый - ['скорый']
вирус - ['вирус']
огэк - ['огэк']
росхолэкспорт - ['росхолэкспорт']
emailengineerkpfuru - ['emailengineerkpfuru']
фарит - ['фарит']
улица - ['улица']
закон - ['закон']
зоология - ['зоология']
организациифио - ['организациифио']
госзадание - ['госзадание']
степень - ['степень']
диалог - ['диалог']
software - ['software']
пи - ['пи']
datavision - ['datavision']
шиномонтаж - ['шиномонтаж']
плохо - ['плохо']
план - ['план']
пцр - ['пцр']
удача - ['удача']
местпо - ['местпо']
ирак - ['ирак']
микроскопия - ['микроскопия']
карта - ['карта']
приступить - ['приступить']
prотдел - ['prотдел']
кгу - ['кгу']
вена - ['вена']
член - ['член']
клип - ['клип']
подобный - ['подобный']
строй - ['строй']
usa - ['usa']
technology - ['technology']
аккаунт - ['аккаунт']
наноинженерия - ['наноинженерия']
ильясович - ['ильясович']
в - ['в']
донор - ['донор']
шея - ['шея']
университетuniver - ['университетuniver']
икт - ['икт']
агроинформатика - ['агроинформатика']
расчёт - ['расчёт']
визитный - ['визитный']
целый - ['целый']
clc - ['clc']
когда - ['когда']
prстратегия - ['prстратегия']
чехов - ['чехов']
льгота - ['льгота']
зимний - ['зимний']
император - ['император']
штат - ['штат']
вак - ['вак']
любим - ['любим']
серьёзный - ['серьёзный']
закрытый - ['закрытый']
алиса - ['алиса']
ресторан - ['ресторан']
юсвр - ['юсвр']
внебюджетный - ['внебюджетный']
int - ['int']
вооружённый - ['вооружённый']
технология - ['технология']
support - ['support']
ee - ['ee']
пять - ['пять']
репродуктивный - ['репродуктивный']
лига - ['лига']
спектакль - ['спектакль']
договорапункт - ['договорапункт']
влиять - ['влиять']
михаилович - ['михаилович']
осадка - ['осадка']
полимирие - ['полимирие']
практикаотдел - ['практикаотдел']
квалификацииучёт - ['квалификацииучёт']
настраивать - ['настраивать']
проводить - ['проводить']
склад - ['склад']
гто - ['гто']
штырлина - ['штырлина']
эндже - ['эндже']
контингент - ['контингент']
ран - ['ран']
тюркский - ['тюркский']
же - ['же']
бумага - ['бумага']
доб - ['доб']
синхронный - ['синхронный']
языкематематик - ['языкематематик']
странахучастник - ['странахучастник']
охранный - ['охранный']
основный - ['основный', 'основное']
кфуотчёт - ['кфуотчёт']
технокласс - ['технокласс']
архив - ['архив']
час - ['час']
поощрение - ['поощрение']
счёт - ['счёт']
желать - ['желать']
корпорейшн - ['корпорейшн']
педагогорганизатор - ['педагогорганизатор']
медмагистратурыифмиб - ['медмагистратурыифмиб']
водить - ['водить']
фантазия - ['фантазия']
время - ['время']
лн - ['лн']
тд - ['тд']
лихачёв - ['лихачёв']
чтобы - ['чтобы']
более - ['более']
достоверность - ['достоверность']
фгбоу - ['фгбоу']
анализ - ['анализ']
жареный - ['жареный']
ревизор - ['ревизор']
опоза - ['опоза']
фахрутдин - ['фахрутдинов']
долгий - ['долгий']
лицензия - ['лицензия']
биосистема - ['биосистема']
запятая - ['запятая']
for - ['for']
ipsum - ['ipsum']
массмедия - ['массмедия']
acm - ['acm']
организм - ['организм']
наукиза - ['наукиза']
пока - ['пока']
членовкорреспондент - ['членовкорреспондент']
анонс - ['анонс']
desk - ['desk']
проход - ['проход']
пригодиться - ['пригодиться']
много - ['много']
мой - ['мой']
режимепамятка - ['режимепамятка']
гибкий - ['гибкий']
practice - ['practice']
ндфл - ['ндфл']
копиялист - ['копиялист']
развить - ['развить']
десяток - ['десятка']
кпп - ['кпп']
кг - ['кг']
ряд - ['ряд']
реаниматолог - ['реаниматолог']
аттестатдиплый - ['аттестатдиплый']
сабит - ['сабит']
чей - ['чей']
персонал - ['персонал']
интернейшнлказань - ['интернейшнлказань']
альтернативный - ['альтернативный']
контакт - ['контакт']
инфраструктура - ['инфраструктура']
искать - ['искать']
be - ['be']
coddy - ['coddy']
русфонд - ['русфонд']
сентябрь - ['сентябрь']
провести - ['провести']
профилибиология - ['профилибиология']
мроттакж - ['мроттакж']
фгаоу - ['фгаоу']
первокурсник - ['первокурсник']
альфабанка - ['альфабанка']
идентичность - ['идентичность']
интеграл - ['интеграл']
байрам - ['байрам']
разница - ['разница']
dub - ['dub']
редкий - ['редкий']
european - ['european']
видеоролик - ['видеоролик']
всегда - ['всегда']
близлежащий - ['близлежащий']
рс - ['рс']
азат - ['азат']
кфу - ['кфу']
вокруг - ['вокруг']
tgt - ['tgt']
миронов - ['миронов']
август - ['август']
туризминдустрия - ['туризминдустрия']
полдник - ['полдник']
педагог - ['педагог']
проводиться - ['проводиться']
карате - ['карате']
ситдиков - ['ситдиков']
равный - ['равный']
миома - ['миома']
грнтить - ['грнтить']
быт - ['быт']
нумерация - ['нумерация']
абсолютно - ['абсолютно']
стоматолог - ['стоматолог']
миллабнуть - ['миллабнуть']
проявить - ['проявить']
журнал - ['журнал']
схема - ['схема']
природопользование - ['природопользование']
криогенный - ['криогенный']
неядерный - ['неядерный']
этот - ['этот']
сценаристика - ['сценаристика']
студенческий - ['студенческий']
шесть - ['шесть']
госнииохт - ['госнииохта']
химикат - ['химикат']
вместо - ['вместо']
занять - ['занять']
репетитор - ['репетитор']
зона - ['зона']
нургалиевич - ['нургалиевич']
пролонгация - ['пролонгация']
иткоманда - ['иткоманда']
въезд - ['въезд']
мп - ['мп']
фцп - ['фцп']
проктереть - ['проктереть']
sustainable - ['sustainable']
первый - ['первый']
детисирота - ['детисирота']
газадлить - ['газадлить']
итспециалист - ['итспециалист']
tools - ['tools']
база - ['база']
nvkalachevagmailcom - ['nvkalachevagmailcom']
црк - ['црк']
of - ['of']
видео - ['видео']
сосновый - ['сосновый']
мойджалиль - ['мойджалиль']
скальпель - ['скальпель']
неоднократно - ['неоднократно']
communicative - ['communicative']
жидкий - ['жидкий']
гр - ['гр']
гнижний - ['гнижний']
студентовсоциолог - ['студентовсоциолог']
самга - ['самга']
продавец - ['продавец']
ганапа - ['ганапа']
ресогарантия - ['ресогарантия']
часть - ['часть']
щелкун - ['щелкун']
цорок - ['цорок']
рубежомтатарстанский - ['рубежомтатарстанский']
гарифуллович - ['гарифуллович']
межрайонный - ['межрайонный']
ет - ['ет']
xiii - ['xiii']
всэк - ['всэк']
сначала - ['сначала']
превентология - ['превентология']
томография - ['томография']
лаборант - ['лаборант']
сборник - ['сборник']
page - ['page']
марафон - ['марафон']
решить - ['решить']
акция - ['акция']
секретарь - ['секретарь']
ан - ['ан']
рак - ['рак']
минеев - ['минеев']
унида - ['унида']
теор - ['теор']
ординатура - ['ординатура']
мнение - ['мнение']
регистраци - ['регистраци']
lab - ['lab']
коррупция - ['коррупция']
французский - ['французский']
алдона - ['алдон']
логика - ['логика']
модернизация - ['модернизация']
экономикистипендия - ['экономикистипендия']
наряду - ['наряду']
кибернетика - ['кибернетика']
рнбашнипинефть - ['рнбашнипинефть']
профитдевелопмент - ['профитдевелопмент']
ммежлаука - ['ммежлаука']
ios - ['ios']
вячеславович - ['вячеславович']
httpsadmissionskpfuru - ['httpsadmissionskpfuru']
потанин - ['потанин']
волонтёр - ['волонтёр']
document - ['document']
wwwkpfurualumnus - ['wwwkpfurualumnus']
запрос - ['запрос']
дилер - ['дилер']
алина - ['алина']
тасмо - ['тасмо']
лекторий - ['лекторий']
посвятить - ['посвятить']
зависимый - ['зависимый']
философ - ['философ']
историография - ['историография']
горка - ['горка']
i - ['i']
ага - ['ага']
секретарьмосолок - ['секретарьмосолков']
отлично - ['отлично']
здравушко - ['здравушко']
бэбиклуб - ['бэбиклуб']
вс - ['вс']
почти - ['почти']
полигон - ['полигон']
odokfumailru - ['odokfumailru']
диетолог - ['диетолог']
лицейинтернат - ['лицейинтернат']
стандарт - ['стандарт']
эб - ['эб']
луиза - ['луиза']
братьевсестер - ['братьевсестер']
четверть - ['четверть']
альфаскан - ['альфаскан']
этнопсихология - ['этнопсихология']
доманик - ['домаников']
снг - ['снг']
xv - ['xv']
урбоэкология - ['урбоэкология']
doc - ['doc']
быстро - ['быстро']
видеофильм - ['видеофильм']
методология - ['методология']
психология - ['психология']
ваш - ['ваш']
страна - ['страна']
кинг - ['кинг']
нагрудный - ['нагрудный']
брать - ['брать']
рамилевнаспециалист - ['рамилевнаспециалист']
проникновение - ['проникновение']
городок - ['городок']
служащий - ['служащий']
гринта - ['гринта']
игорь - ['игорь']
бланк - ['бланк']
фархан - ['фархан']
сотня - ['сотня']
elsevier - ['elsevier']
начисляться - ['начисляться']
прохоров - ['прохоров']
iтлицей - ['iтлицей']
инэк - ['инэк']
аспект - ['аспект']
сметнодоговорный - ['сметнодоговорный']
физиология - ['физиология']
бывать - ['бывать']
emailvmkdepkpfuru - ['emailvmkdepkpfuru']
a - ['a']
учение - ['учение']
яким - ['якимов']
ринат - ['ринат']
геоинформатикагеоинформационный - ['геоинформатикагеоинформационный']
ximad - ['ximad']
литературоведение - ['литературоведение']
биотехнология - ['биотехнология']
императорский - ['императорский']
конго - ['конго']
узгенский - ['узгенский']
интерактивный - ['интерактивный']
степеняхдокумент - ['степеняхдокумент']
улибрагим - ['улибрагимов']
онкология - ['онкология']
александр - ['александр']
тяжёлый - ['тяжёлый']
нирс - ['нирс']
я - ['я']
медиатека - ['медиатека']
федерация - ['федерация']
татнефтьазс - ['татнефтьазс']
спорткомплекс - ['спорткомплекс']
экстерн - ['экстерн']
командный - ['командный']
train - ['train']
услугприказ - ['услугприказ']
hspakpfuru - ['hspakpfuru']
enable - ['enable']
журналистикататарский - ['журналистикататарский']
компаниипартнёр - ['компаниипартнер']
роснефть - ['роснефть']
product - ['product']
прежде - ['прежде']
week - ['week']
xxv - ['xxv']
метод - ['метод']
плакат - ['плакат']
креатор - ['креатор']
твит - ['твит']
карьерес - ['карьерес']
стюард - ['стюард']
труд - ['труд']
hack - ['hack']
фергана - ['фергана']
навои - ['навои']
будущее - ['будущее']
телефонвид - ['телефонвид']
aspirantpriemkpfuru - ['aspirantpriemkpfuru']
сила - ['сила']
масштаб - ['масштаб']
тракт - ['тракт']
тысяча - ['тысяча']
httpstildacc - ['httpstildacc']
брайль - ['брайль']
агентство - ['агентство']
тоже - ['тоже']
ислам - ['ислам']
приезжать - ['приезжать']
rtf - ['rtf']
радиф - ['радиф']
горюн - ['горюнов']
ткань - ['ткань']
дождь - ['дождь']
достигнуть - ['достигнуть']
процессв - ['процессв']
ткачёв - ['ткачёв']
ковчег - ['ковчег']
пандемия - ['пандемия']
фёдор - ['фёдор']
иэуп - ['иэуп']
fun - ['fun']
бустан - ['бустан']
фитнестренер - ['фитнестренер']
сто - ['сто']
контент - ['контент']
роботсимулятор - ['роботсимулятор']
татнипинефть - ['татнипинефть']
алексеевский - ['алексеевский']
габдрахман - ['габдрахманов']
победа - ['победа']
слышать - ['слышать']
мицай - ['мицай']
студентовстипендия - ['студентовстипендия']
гузель - ['гузель']
судебный - ['судебный']
бизнеспроцесс - ['бизнеспроцесс']
ремдизель - ['ремдизель']
дин - ['дин']
участие - ['участие']
глобальный - ['глобальный']
режиссёр - ['режиссёр']
агрегатор - ['агрегатор']
httpabiturientkpfuru - ['httpabiturientkpfuru']
мэрия - ['мэрия']
иа - ['иа']
хавкин - ['хавкин']
биолог - ['биолог']
интерактив - ['интерактив']
другиеинформация - ['другиеинформация']
оборона - ['оборона']
хабаровск - ['хабаровск']
авто - ['авто']
высота - ['высота']
нилобачевский - ['нилобачевский']
кардиограмма - ['кардиограмма']
vi - ['vi']
добрый - ['добрый']
видный - ['видный']
prменеджер - ['prменеджер']
консалтинг - ['консалтинг']
саулыко - ['саулыко']
физикаматематика - ['физикаматематика']
финал - ['финал']
лизинг - ['лизинг']
вмк - ['вмк']
голос - ['голос']
криминология - ['криминология']
семинар - ['семинар']
инженер - ['инженер']
антиконференция - ['антиконференция']
инженерияаналитика - ['инженерияаналитик']
docsvision - ['docsvision']
ка - ['ка']
вперёд - ['вперёд']
нио - ['нио']
workkpfuru - ['workkpfuru']
участь - ['участь']
мв - ['мв']
травма - ['травма']
мвломонос - ['мвломоносов']
гизат - ['гизатов']
майконкурс - ['майконкурс']
членство - ['членство']
газпромнефть - ['газпромнефть']
publicmailkpfuru - ['publicmailkpfuru']
фасоль - ['фасоль']
engineer - ['engineer']
данафлекс - ['данафлекс']
активизация - ['активизация']
ти - ['ти']
мджалиль - ['мджалиль']
калейдоскоп - ['калейдоскоп']
популяризатор - ['популяризатор']
ахметшин - ['ахметшин']
клиника - ['клиника']
бизнесомбизнесаналитика - ['бизнесомбизнесаналитик']
рафаэловнапризнание - ['рафаэловнапризнание']
эльдар - ['эльдар']
биофизик - ['биофизик']
internatinal - ['internatinal']
автобиография - ['автобиография']
хайер - ['хайер']
августоктябрьплан - ['августоктябрьплан']
жанр - ['жанр']
магистр - ['магистр']
ленин - ['ленин']
правда - ['правда']
цвснп - ['цвснп']
республика - ['республика']
экскурсия - ['экскурсия']
регион - ['регион']
flipflopart - ['flipflopart']
битрикс - ['битрикс']
emailrnsayfutdinovkpfuru - ['emailrnsayfutdinovkpfuru']
эльдорадо - ['эльдорадо']
стационар - ['стационар']
рцдп - ['рцдп']
дизайнер - ['дизайнер']
теплофизика - ['теплофизика']
филологиятюркология - ['филологиятюркология']
bitrix - ['bitrix']
общий - ['общий']
капиталь - ['капиталь']
гнабережный - ['гнабережный']
обращать - ['обращать']
рубрикатор - ['рубрикатор']
казаньэкспо - ['казаньэкспо']
корректор - ['корректор']
кривоногий - ['кривоног']
php - ['php']
string - ['string']
университетасегодний - ['университетасегодний']
модератор - ['модератор']
тематика - ['тематика']
әдәбият - ['әдәбият']
немецкий - ['немецкий']
шаляпин - ['шаляпин']
рудницкий - ['рудницкий']
этика - ['этика']
конструкция - ['конструкция']
митапа - ['митапа']
копийприказ - ['копийприказ']
сестра - ['сестра']
объём - ['объём']
староосманский - ['староосманский']
luaplotnikovakpfuru - ['luaplotnikovakpfuru']
курносов - ['курносов']
средство - ['средство']
электротехника - ['электротехника']
this - ['this']
бюджет - ['бюджет']
вооружение - ['вооружение']
гульчачак - ['гульчачак']
наукиотдел - ['наукиотдел']
interneturok - ['interneturok']
хо - ['хо']
кфупамятка - ['кфупамятка']
аппаратура - ['аппаратура']
дружный - ['дружный']
энд - ['энд']
httpskpfuruportaldocsfoformlenieizaseleniestarshekursnikovpdf - ['httpskpfuruportaldocsfoformlenieizaseleniestarshekursnikovpdf']
андрей - ['андрей']
бояться - ['бояться']
исламский - ['исламский']
умный - ['умный']
он - ['он']
кфуназначаться - ['кфуназначаться']
финансы - ['финансы']
переезд - ['переезд']
ильдус - ['ильдус']
preparatorykpfuru - ['preparatorykpfuru']
приступ - ['приступ']
сагдиева - ['сагдиева']
факультетский - ['факультетский']
острый - ['острый']
забыть - ['забыть']
алишер - ['алишер']
эндокринология - ['эндокринология']
шалабан - ['шалабанов']
микрорнк - ['микрорнк']
носитель - ['носитель']
пратик - ['пратик']
годовщина - ['годовщина']
падать - ['падать']
радикович - ['радикович']
спобиология - ['спобиология']
автоваз - ['автоваз']
организациейпункт - ['организациейпункт']
браузер - ['браузер']
тимур - ['тимур']
пример - ['пример']
повод - ['повод']
математикаметод - ['математикаметод']
иммунология - ['иммунология']
реакция - ['реакция']
онлайнпрезентация - ['онлайнпрезентация']
онлайнпрактика - ['онлайнпрактика']
всесторонний - ['всесторонний']
гидропневмоавтоматика - ['гидропневмоавтоматика']
перенос - ['перенос']
отзыв - ['отзыв']
вицечемпион - ['вицечемпион']
техносферный - ['техносферный']
юристконсультант - ['юристконсультант']
мягкий - ['мягкий']
ипио - ['ипио']
фрегат - ['фрегат']
катализ - ['катализ']
бурить - ['бурил']
подход - ['подход']
работодателейреестр - ['работодателейреестр']
along - ['along']
оплата - ['оплата']
универсиада - ['универсиада']
zrkkpfugmailcom - ['zrkkpfugmailcom']
фактор - ['фактор']
месяцполтор - ['месяцполтор']
radeant - ['radeant']
ветеринария - ['ветеринария']
галиев - ['галиев']
казённый - ['казённый']
основатель - ['основатель']
молодёжный - ['молодёжный']
вызов - ['вызов']
нефтехимия - ['нефтехимия']
рамадан - ['рамадан']
хи - ['хи']
анисимов - ['анисимов']
обходный - ['обходный']
доступно - ['доступно']
фархад - ['фархад']
егпу - ['егпу']
тутубалин - ['тутубалин']
объединять - ['объединять']
апк - ['апк']
языкинформатика - ['языкинформатика']
неделя - ['неделя']
амбассадор - ['амбассадор']
входящий - ['входящий']
денвер - ['денвер']
альберт - ['альберт']
актовый - ['актовый']
к - ['к']
smmспециалист - ['smmспециалист']
козырев - ['козырев']
по - ['по']
применение - ['применение']
порода - ['порода']
парень - ['парень']
испания - ['испания']
отец - ['отец']
учёт - ['учёт']
якупа - ['якуп']
медиация - ['медиация']
фадеев - ['фадеев']
значимый - ['значимый']
фкп - ['фкп']
ramsagmailru - ['ramsagmailru']
ход - ['ход']
интернетмаркетолог - ['интернетмаркетолог']
терапевтучастковый - ['терапевтучастковый']
бухгалтерия - ['бухгалтерия']
легендарный - ['легендарный']
татэнерго - ['татэнерго']
признак - ['признак']
мәктәп - ['мәктәп']
олимпиадаvii - ['олимпиадаvii']
devochka - ['devochka']
виза - ['виза']
лингвистика - ['лингвистика']
гораздо - ['гораздо']
еврокаскад - ['еврокаскад']
внк - ['внк']
пунктышапка - ['пунктышапка']
пк - ['пк']
биосурфактант - ['биосурфактант']
профессионализм - ['профессионализм']
являться - ['являться']
рублейсменабонусыпремия - ['рублейсменабонусыпремия']
эпидемиология - ['эпидемиология']
biology - ['biology']
xx - ['xx']
давлетгильдеев - ['давлетгильдеев']
кфудоговор - ['кфудоговор']
династия - ['династия']
какиелибо - ['какиелибо']
улпушкин - ['улпушкин']
ординатор - ['ординатор']
ikayumovkpfuru - ['ikayumovkpfuru']
рустам - ['рустам']
старшина - ['старшина']
фзминистерство - ['фзминистерство']
la - ['la']
пусть - ['пусть']
кадастр - ['кадастр']
гбпоу - ['гбпоу']
блог - ['блог']
университетмалый - ['университетмалый']
centeregekpfuru - ['centeregekpfuru']
контроль - ['контроль']
фаргатович - ['фаргатович']
диляр - ['диляр']
двукратно - ['двукратно']
запас - ['запас']
метеоролог - ['метеоролог']
pressakpfuru - ['pressakpfuru']
физкультура - ['физкультура']
бригада - ['бригада']
art - ['art']
культорг - ['культорг']
призёр - ['призёр']
модель - ['модель']
радиация - ['радиация']
особый - ['особый']
старейшина - ['старейшина']
гфз - ['гфз']
изобретение - ['изобретение']
пара - ['пара']
религия - ['религия']
звать - ['звать']
понемецк - ['понемецк']
выявить - ['выявить']
оператор - ['оператор']
моу - ['моу']
ильшат - ['ильшат']
апробация - ['апробация']
сектор - ['сектор']
единый - ['единый']
бс - ['бс']
проезд - ['проезд']
важно - ['важно']
manager - ['manager']
гватемала - ['гватемала']
микрорайон - ['микрорайон']
обычно - ['обычно']
пю - ['пю']
вьетнамский - ['вьетнамский']
парус - ['парус']
приёмная - ['приёмная']
инфекция - ['инфекция']
приём - ['приём']
park - ['park']
сафиуллин - ['сафиуллин']
песня - ['песня']
мубаракович - ['мубаракович']
итисбакалавриат - ['итисбакалавриат']
информатикевсе - ['информатикевсе']
orus - ['orus']
главэкспертцентр - ['главэкспертцентр']
дисциплина - ['дисциплина']
реанимация - ['реанимация']
катар - ['катар']
внедряться - ['внедряться']
escrh - ['escrh']
медведев - ['медведев']
гармоника - ['гармоника']
отбор - ['отбор']
рчц - ['рчц']
предмагистратура - ['предмагистратура']
гелабуга - ['гелабуга']
календарный - ['календарный']
кто - ['кто']
преподавателейинструкция - ['преподавателейинструкция']
соломон - ['соломон']
там - ['там']
орлёнок - ['орлёнок']
хабибуллин - ['хабибуллин']
сделка - ['сделка']
агрометеорология - ['агрометеорология']
мороз - ['мороз']
патология - ['патология']
пиридоксин - ['пиридоксин']
цена - ['цена']
кгукф - ['кгукф']
p - ['p']
лобачёвка - ['лобачёвка']
педагогика - ['педагогика']
местный - ['местный']
вследствие - ['вследствие']
мария - ['мария']
решающий - ['решающий']
обувь - ['обувь']
палата - ['палата']
чеклист - ['чеклист']
гулгу - ['гулгу']
приемнаяауд - ['приемнаяауд']
technologies - ['technologies']
исгрп - ['исгрп']
поликлиника - ['поликлиника']
игинт - ['игинт']
приклеить - ['приклеить']
киләчәг - ['киләчәг']
universum - ['universum']
ипотека - ['ипотека']
северный - ['северный']
ргприложение - ['ргприложение']
казаньтольятти - ['казаньтольятти']
передача - ['передача']
калимуллин - ['калимуллин']
онлайншкола - ['онлайншкола']
форма - ['форма']
call - ['call']
позиция - ['позиция']
español - ['español']
доска - ['доска']
прозаик - ['прозаик']
асу - ['асу']
менеджерадминистратор - ['менеджерадминистратор']
бизнесинформатика - ['бизнесинформатика']
термодинамика - ['термодинамика']
экспертный - ['экспертный']
начинаться - ['начинаться']
выходной - ['выходной']
чукмара - ['чукмар']
сводный - ['сводный']
комиссия - ['комиссия']
гапоу - ['гапоу']
весь - ['весь']
рад - ['рад']
ремарк - ['ремарк']
профессия - ['профессия']
назаров - ['назаров']
ю - ['ю']
dokpfuruновый - ['dokpfuruновый']
прикамье - ['прикамье']
нв - ['нв']
myclass - ['myclass']
уборка - ['уборка']
frankenhaus - ['frankenhaus']
пандус - ['пандус']
интернет - ['интернет']
многий - ['многий']
кампить - ['кампить']
здравствуй - ['здравствуй']
так - ['так']
спортивный - ['спортивный']
технологиистратегия - ['технологиистратегия']
вн - ['вн']
векаапрельконкурс - ['векаапрельконкурс']
надзор - ['надзор']
нцм - ['нцм']
они - ['они']
народ - ['народ']
компания - ['компания']
звездин - ['звездин']
ежегодно - ['ежегодно']
радиофизика - ['радиофизика']
capitalneurodata - ['capitalneurodata']
салимовнаведущий - ['салимовнаведущий']
меморандум - ['меморандум']
навык - ['навык']
ришатович - ['ришатович']
кфуоб - ['кфуоб']
господин - ['господин']
познание - ['познание']
отпуск - ['отпуск']
реклама - ['реклама']
участник - ['участник']
rw - ['rw']
фронтменеджерменеджер - ['фронтменеджерменеджер']
ризванович - ['ризванович']
почёт - ['почёт']
трудоустройство - ['трудоустройство']
сайдашева - ['сайдашева']
чф - ['чф']
галина - ['галина']
слепоглухой - ['слепоглухой']
фестиваль - ['фестиваль']
суббота - ['суббота']
вуз - ['вуз']
стобалльникназначаться - ['стобалльникназначаться']
рахматуллин - ['рахматуллин']
книжный - ['книжный']
равно - ['равно']
размер - ['размер']
softline - ['softline']
assozkpfuru - ['assozkpfuru']
covidуказ - ['covidуказ']
кфусоглашение - ['кфусоглашение']
data - ['data']
тобакко - ['тобакко']
рх - ['рх']
хуссеин - ['хуссеин']
scholarship - ['scholarship']
магистратура - ['магистратура']
задачорганизация - ['задачорганизация']
methods - ['methods']
ученогометодист - ['ученогометодист']
экономикаэкономика - ['экономикаэкономик']
циркуляция - ['циркуляция']
свезалеса - ['свезалеса']
гиматдинов - ['гиматдинов']
it - ['it']
аиг - ['аиг']
бассейн - ['бассейн']
хазип - ['хазип']
лукойлинжиниринг - ['лукойлинжиниринг']
приравнять - ['приравнять']
универ - ['универ']
койкоместо - ['койкоместо']
усилие - ['усилие']
интернетконкурс - ['интернетконкурс']
digitalмаркетолог - ['digitalмаркетолог']
тревелшоу - ['тревелшоу']
билайн - ['билайн']
наолиссиа - ['наолиссиа']
пересдача - ['пересдача']
документовстраныучастница - ['документовстраныучастница']
волгаволга - ['волгаволга']
эбс - ['эбс']
пс - ['пс']
юбилеевцикл - ['юбилеевцикл']
комбинат - ['комбинат']
logical - ['logical']
тестировщик - ['тестировщик']
укуча - ['укуч']
медиа - ['медиа']
как - ['как']
оао - ['оао']
политология - ['политология']
явь - ['явь']
ксккф - ['ксккф']
робототехникатехнология - ['робототехникатехнология']
миррико - ['миррико']
нейрокогнитивный - ['нейрокогнитивный']
а - ['а']
герой - ['герой']
сдать - ['сдать']
эйдосмедицина - ['эйдосмедицина']
промоутер - ['промоутер']
кардиология - ['кардиология']
теология - ['теология']
документынаука - ['документынаука']
онлайнплощадка - ['онлайнплощадка']
горный - ['горный']
фамилия - ['фамилия']
fotogram - ['fotogram']
копия - ['копия']
кфусентябрь - ['кфусентябрь']
санкция - ['санкция']
xxiv - ['xxiv']
минувший - ['минувший']
видеошаблон - ['видеошаблон']
финансовый - ['финансовый']
лёгкий - ['лёгкий']
ргнф - ['ргнф']
вилейк - ['вилейк']
meflovagmailcom - ['meflovagmailcom']
топменеджер - ['топменеджер']
консультация - ['консультация']
станислав - ['станислав']
аа - ['аа']
катастрофа - ['катастрофа']
литология - ['литология']
принятие - ['принятие']
грудной - ['грудной']
договорудоговор - ['договорудоговор']
над - ['над']
добыча - ['добыча']
теплоэнергетика - ['теплоэнергетика']
терапевт - ['терапевт']
камский - ['камский']
кино - ['кино']
доминанта - ['доминанта']
родитель - ['родитель']
с - ['с']
android - ['android']
фку - ['фку']
услугквитанция - ['услугквитанция']
инвентарь - ['инвентарь']
гербицид - ['гербицид']
футбольный - ['футбольный']
кнопка - ['кнопка']
хотеть - ['хотеть']
булгарпиво - ['булгарпиво']
татяз - ['татяз']
artificial - ['artificial']
гм - ['гм']
экзамуса - ['экзамуса']
комплектовщик - ['комплектовщик']
ифмибосновный - ['ифмибосновный']
xxviii - ['xxviii']
санаториипрофилактория - ['санаториипрофилактория']
спектр - ['спектр']
технологийматематика - ['технологийматематика']
дубяго - ['дубяго']
зд - ['зд']
хименес - ['хименес']
весьма - ['весьма']
линза - ['линза']
onlinekpfuru - ['onlinekpfuru']
часто - ['часто']
погода - ['погода']
geosciences - ['geosciences']
равефовен - ['равефовен']
э - ['э']
theor - ['theor']
указ - ['указ']
подфак - ['подфак']
профильискусство - ['профильискусство']
мексика - ['мексика']
от - ['от']
сезон - ['сезон']
студент - ['студент']
мфц - ['мфц']
усманович - ['усманович']
кольцо - ['кольцо']
иабодуэн - ['иабодуэн']
кластер - ['кластер']
xvi - ['xvi']
лето - ['лето']
предбакалавриат - ['предбакалавриат']
только - ['только']
перечный - ['перечный']
ландшафтный - ['ландшафтный']
пожар - ['пожар']
университет - ['университет']
стена - ['стена']
абзал - ['абзал']
четырёхкратный - ['четырёхкратный']
применять - ['применять']
development - ['development']
ермолаев - ['ермолаев']
себя - ['себя']
радиофизикаквантовый - ['радиофизикаквантовый']
американа - ['американа']
булгар - ['булгар']
эквивалентность - ['эквивалентность']
трансформация - ['трансформация']
фотоархив - ['фотоархив']
верный - ['верный']
христианский - ['христианский']
дисграфия - ['дисграфия']
валютный - ['валютный']
умр - ['умр']
вузамипартнёр - ['вузамипартнер']
драйвер - ['драйвер']
вещь - ['вещь']
зрение - ['зрение']
online - ['online']
мозаика - ['мозаика']
совещание - ['совещание']
квиза - ['квиза']
цоб - ['цоб']
бронхиальный - ['бронхиальный']
lilianamailru - ['lilianamailru']
ах - ['ах']
геохимия - ['геохимия']
уфссп - ['уфссп']
людмила - ['людмила']
факультет - ['факультет']
секция - ['секция']
кгфэя - ['кгфэя']
lingvоhack - ['lingvоhack']
ежегодный - ['ежегодный']
смена - ['смена']
личностимартii - ['личностимартii']
презентацияпрограмма - ['презентацияпрограмма']
члкорра - ['члкорра']
гавриил - ['гавриил']
терроризм - ['терроризм']
фатхутдин - ['фатхутдинов']
ххi - ['ххi']
конструктор - ['конструктор']
около - ['около']
englishcentreimoivmailru - ['englishcentreimoivmailru']
кирмень - ['кирмень']
биоресурсы - ['биоресурсы']
честь - ['честь']
инженергеолог - ['инженергеолог']
технологийнаука - ['технологийнаука']
conference - ['conference']
арендатор - ['арендатор']
бизнесомфинансовый - ['бизнесомфинансовый']
граница - ['граница']
кандидат - ['кандидат']
гауз - ['гауз']
ярмарка - ['ярмарка']
mars - ['mars']
инструкция - ['инструкция']
инжиниринг - ['инжиниринг']
ректор - ['ректор']
onokpfuru - ['onokpfuru']
faculty - ['faculty']
чеботарёв - ['чеботарёв']
биохимик - ['биохимик']
аксиома - ['аксиома']
андреев - ['андреев']
апрель - ['апрель']
университетприказ - ['университетприказ']
комплектация - ['комплектация']
дозатор - ['дозатор']
liii - ['liii']
контрактный - ['контрактный']
хотя - ['хотя']
элементарный - ['элементарный']
полуфинал - ['полуфинал']
квота - ['квота']
тогда - ['тогда']
gas - ['gas']
кредит - ['кредит']
логопедиябиология - ['логопедиябиология']
liza - ['liza']
госзаказ - ['госзаказ']
консультант - ['консультант']
fix - ['fix']
полимерный - ['полимерный']
летболее - ['летболее']
потолок - ['потолок']
учебник - ['учебник']
итфакультет - ['итфакультет']
принять - ['принять']
русый - ['русый']
нти - ['нти']
каникулы - ['каникулы']
suite - ['suite']
нпр - ['нпр']
казаться - ['казаться']
второй - ['второй']
мирзагио - ['мирзагио']
историкокультурный - ['историкокультурный']
тукай - ['тукай']
кфуправило - ['кфуправило']
униклиника - ['униклиника']
антология - ['антология']
эл - ['эл']
иван - ['иван']
васильев - ['васильев']
лингвист - ['лингвист']
education - ['education']
тор - ['тор']
faq - ['faq']
углевод - ['углевод']
делать - ['делать']
ucsfkpfuru - ['ucsfkpfuru']
модерация - ['модерация']
норматив - ['норматив']
путин - ['путин']
крайний - ['крайний']
вариант - ['вариант']
уралсиб - ['уралсиб']
гафур - ['гафур', 'гафуров']
горячий - ['горячий']
медиакоммуникациимедакоммуникация - ['медиакоммуникациимедакоммуникация']
механизм - ['механизм']
mbakazankpfuru - ['mbakazankpfuru']
технологийэкскурсия - ['технологийэкскурсия']
у - ['у']
гнижнекамск - ['гнижнекамск']
предъявить - ['предъявить']
кпк - ['кпк']
тест - ['тест']
коллега - ['коллега']
лицей - ['лицей']
пт - ['пт']
известие - ['известие']
каюм - ['каюм', 'каюмов']
комсомол - ['комсомол']
активный - ['активный']
геобрендинг - ['геобрендинг']
иностранец - ['иностранец']
шкала - ['шкала']
вакансииуниверситет - ['вакансииуниверситет']
регенеративный - ['регенеративный']
экспресскурс - ['экспресскурс']
здравствуйте - ['здравствуйте']
tango - ['tango']
школыинтернат - ['школыинтернат']
апарель - ['апарель']
медиацентр - ['медиацентр']
дата - ['дата']
кожа - ['кожа']
выше - ['выше']
месяц - ['месяц']
ск - ['ск']
ch - ['ch']
medicine - ['medicine']
хайдар - ['хайдар']
мисс - ['мисс']
приоритет - ['приоритет']
стройподряд - ['стройподряд']
дедушка - ['дедушка']
студентка - ['студентка']
шимкий - ['шимкий']
мкр - ['мкр']
сочи - ['сочи']
бережно - ['бережно']
излишний - ['излишний']
unitech - ['unitech']
адвокат - ['адвокат']
ошкина - ['ошкина']
сунбуля - ['сунбуля']
зоомагазин - ['зоомагазин']
гульнара - ['гульнара']
дверь - ['дверь']
тогбуз - ['тогбуз']
гволгоград - ['гволгоград']
рнсахалинморнефтегаз - ['рнсахалинморнефтегаз']
вне - ['вне']
контейнер - ['контейнер']
теплотехник - ['теплотехник']
тайна - ['тайна']
дочь - ['дочь']
импэкс - ['импэкс']
привести - ['привести']
кадис - ['кадис']
люкс - ['люкс']
опора - ['опора']
тeleperformance - ['тeleperformance']
документовсрок - ['документовсрок']
пр - ['пр']
риск - ['риск']
нано - ['нано']
слово - ['слово']
осознать - ['осознать']
интранет - ['интранет']
галиуллин - ['галиуллин']
теплоход - ['теплоход']
gross - ['gross']
квн - ['квн']
мегафон - ['мегафон']
кража - ['кража']
наркомания - ['наркомания']
консультантплюс - ['консультантплюс']
санитарный - ['санитарный']
корчак - ['корчак']
геология - ['геология']
деканат - ['деканат']
layer - ['layer']
предаспирантура - ['предаспирантура']
галицкий - ['галицкий']
штаб - ['штаб']
канцелярия - ['канцелярия']
переподготовка - ['переподготовка']
наука - ['наука']
унистра - ['унистра']
бессрочный - ['бессрочный']
гижевск - ['гижевск']
душа - ['душа']
уметь - ['уметь']
emailmedbiolkpfuru - ['emailmedbiolkpfuru']
салихзанович - ['салихзанович']
зонт - ['зонт']
частично - ['частично']
лечебный - ['лечебный']
времярезультат - ['времярезультат']
anvmelnikovkpfuru - ['anvmelnikovkpfuru']
бодуэном - ['бодуэном']
результат - ['результат']
викторин - ['викторин']
сабина - ['сабина']
green - ['green']
стипендияназначаться - ['стипендияназначаться']
выход - ['выход']
минералогия - ['минералогия']
кодкласс - ['кодкласс']
станок - ['станок']
укрупнённый - ['укрупнённый']
великий - ['великий']
момент - ['момент']
стартап - ['стартап']
техногенный - ['техногенный']
новый - ['новый']
звездцентр - ['звездцентр']
башак - ['башак']
кооператив - ['кооператив']
градус - ['градус']
стратегия - ['стратегия']
концентрация - ['концентрация']
институтахфакультет - ['институтахфакультет']
magna - ['magna']
три - ['три']
ца - ['ца']
амгорький - ['амгорький']
вк - ['вк']
июльавгуст - ['июльавгуст']
налог - ['налог']
спец - ['спец']
летие - ['летие']
ментальный - ['ментальный']
пд - ['пд']
арк - ['арк']
аркобъединить - ['аркобъединить']
психологияпсихология - ['психологияпсихология']
таблица - ['таблица']
огромный - ['огромный']
декоративный - ['декоративный']
застава - ['застава']
турция - ['турция']
призвать - ['призвать']
политический - ['политический']
гайдар - ['гайдар']
масленник - ['масленник']
ттс - ['ттс']
дл - ['дл']
кфуга - ['кфуга']
ромашка - ['ромашка']
bekker - ['bekker']
инсектицид - ['инсектицид']
защита - ['защита']
поход - ['поход']
тренажёр - ['тренажёр']
дар - ['дар']
гвма - ['гвма']
сагдеев - ['сагдеев']
ао - ['ао']
обратить - ['обратить']
точка - ['точка']
ректорат - ['ректорат']
оформляться - ['оформляться']
попрежний - ['попрежний']
hysteroscopy - ['hysteroscopy']
ребёнок - ['ребёнок']
гонка - ['гонка']
ксерокопия - ['ксерокопия']
рафаилевич - ['рафаилевич']
аневризм - ['аневризм']
мир - ['мир']
итислоготип - ['итислоготип']
пристать - ['пристав']
primavera - ['primavera']
бритиша - ['бритиша']
конгресс - ['конгресс']
начаться - ['начаться']
альфашанс - ['альфашанс']
фасад - ['фасад']
портфолио - ['портфолио']
студия - ['студия']
ахтям - ['ахтямов']
emailhspakpfuru - ['emailhspakpfuru']
елабуга - ['елабуга']
ретейлер - ['ретейлер']
ифмк - ['ифмк']
emailecologykpfuru - ['emailecologykpfuru']
cдельный - ['cдельный']
японский - ['японский']
стрессфактор - ['стрессфактор']
вместе - ['вместе']
scholar - ['scholar']
пн - ['пн']
выброс - ['выброс']
lms - ['lms']
криминалистика - ['криминалистика']
роботизация - ['роботизация']
вр - ['вр']
споматематикаобществознание - ['споматематикаобществознание']
операционист - ['операционист']
потеря - ['потеря']
нс - ['нс']
спофио - ['спофио']
дебаты - ['дебаты']
правовой - ['правовой']
мустафина - ['мустафина']
симоново - ['симоново']
кафе - ['кафе']
прошин - ['прошин']
электроэнергетика - ['электроэнергетика']
пугать - ['пугать']
горох - ['горох']
владеть - ['владеть']
уход - ['уход']
жильё - ['жильё']
стсгеосервис - ['стсгеосервис']
аквахим - ['аквахим']
учёба - ['учёба']
якубович - ['якубович']
чувство - ['чувство']
ключар - ['ключар']
ассистент - ['ассистент']
лифт - ['лифт']
глубокий - ['глубокий']
клумба - ['клумба']
bimавтор - ['bimавтор']
задание - ['задание']
балльник - ['балльник']
универсум - ['универсум']
тсср - ['тсср']
интернетпродажа - ['интернетпродажа']
httpadmissionskpfuru - ['httpadmissionskpfuru']
рафаэловналегализация - ['рафаэловналегализация']
милль - ['милль']
kpi - ['kpi']
съёмка - ['съёмка']
gilyaevaamailru - ['gilyaevaamailru']
агротехнология - ['агротехнология']
emailimokpfuru - ['emailimokpfuru']
товма - ['товма']
контрольматематик - ['контрольматематик']
aaglmedtronic - ['aaglmedtronic']
геоэкология - ['геоэкология']
квалификацииструктура - ['квалификацииструктура']
конкурсавыбор - ['конкурсавыбор']
отразить - ['отразить']
rczrkuniversumgmailcom - ['rczrkuniversumgmailcom']
нтв - ['нтв']
профессор - ['профессор']
мюфка - ['мюфка']
михаил - ['михаил']
кдис - ['кдис']
математикиавгустцикл - ['математикиавгустцикл']
еминеев - ['еминеев']
рабтело - ['рабтело']
urban - ['urban']
доллар - ['доллар']
ак - ['ак']
правый - ['правый']
самоизоляция - ['самоизоляция']
техникум - ['техникум']
системматематика - ['системматематика']
микробиология - ['микробиология']
спогеография - ['спогеография']
концерн - ['концерн']
нпи - ['нпи']
зао - ['зао']
гн - ['гн']
апостиль - ['апостиль']
логос - ['логос']
иммунитет - ['иммунитет']
анварович - ['анварович']
раз - ['раз']
роландо - ['роландо']
кивина - ['кивина']
ложный - ['ложный']
рнпурнефтегаз - ['рнпурнефтегаз']
нервный - ['нервный']
слепой - ['слепой']
трансгаз - ['трансгаз']
рельефноточечный - ['рельефноточечный']
элекон - ['элекон']
нанотехнология - ['нанотехнология']
центрацентр - ['центрацентр']
камиллеккә - ['камиллеккә']
бой - ['бой']
доставка - ['доставка']
халвалеруа - ['халвалеруа']
унитарный - ['унитарный']
амбулаторный - ['амбулаторный']
очнзаочие - ['очнзаочий']
иктматематик - ['иктматематик']
кончина - ['кончина']
задать - ['задать']
жара - ['жара']
артлантида - ['артлантида']
хосе - ['хосе']
менделеев - ['менделеев']
program - ['program']
медаль - ['медаль']
нефтедобыча - ['нефтедобыча']
цепной - ['цепной']
эссе - ['эссе']
вход - ['вход']
лекцииконференциишаблон - ['лекцииконференциишаблон']
prагентство - ['prагентство']
jalinga - ['jalinga']
мак - ['мак']
перевозка - ['перевозка']
grace - ['grace']
worldskills - ['worldskills']
термин - ['термин']
школьник - ['школьник']
нигматовский - ['нигматовский']
genetics - ['genetics']
обратиться - ['обратиться']
институтафакультет - ['институтафакультет']
вовлечь - ['вовлечь']
ёмкий - ['ёмкий']
publishing - ['publishing']
практикант - ['практикант']
масхутович - ['масхутович']
профориентация - ['профориентация']
pr - ['pr']
конспект - ['конспект']
менеджер - ['менеджер']
синтез - ['синтез']
чат - ['чат']
инкомсистема - ['инкомсистема']
сайфулина - ['сайфулина']
чистополедокумент - ['чистополедокумент']
россиинаш - ['россиинаш']
успешно - ['успешно']
снятой - ['снятой']
интервал - ['интервал']
волейбол - ['волейбол']
прикол - ['прикол']
медик - ['медик']
наследие - ['наследие']
сын - ['сын']
академик - ['академик']
сердце - ['сердце']
повар - ['повар']
монокристалл - ['монокристалл']
классовмарт - ['классовмарт']
медиапроект - ['медиапроект']
вид - ['вид']
гам - ['гам']
лишь - ['лишь']
пункт - ['пункт']
внеучебный - ['внеучебный']
старт - ['старт']
снк - ['снк']
кадровый - ['кадровый']
поручный - ['поручный']
куртенэ - ['куртенэ']
залог - ['залог']
слой - ['слой']
хафиз - ['хафиз']
никитин - ['никитин']
онлайнвебинар - ['онлайнвебинар']
itcпециалист - ['itcпециалист']
университетасентябрьii - ['университетасентябрьii']
сцена - ['сцена']
изделие - ['изделие']
гематома - ['гематома']
исторически - ['исторически']
фазыл - ['фазылов']
юриспруденция - ['юриспруденция']
cо - ['cо']
сам - ['сам']
зерно - ['зерно']
not - ['not']
эпидимиология - ['эпидимиология']
тхэквондо - ['тхэквондо']
ло - ['ло']
старый - ['старый']
баскетбол - ['баскетбол']
дирекция - ['дирекция']
привал - ['привал']
цивилизацииафроазиатский - ['цивилизацииафроазиатский']
директоровдекан - ['директоровдекан']
состоять - ['состоять']
zrkkpfuru - ['zrkkpfuru']
бедствие - ['бедствие']
диспансер - ['диспансер']
your - ['your']
имплантат - ['имплантат']
давать - ['давать']
пуаба - ['пуаба']
хорошо - ['хорошо']
габдельнурович - ['габдельнурович']
егэ - ['егэ']
ася - ['ася']
приказ - ['приказ']
прибор - ['прибор']
ступень - ['ступень']
сн - ['сн']
ниц - ['ниц']
space - ['space']
камаз - ['камаз']
когерентный - ['когерентный']
память - ['память']
круг - ['круг']
интеграция - ['интеграция']
книжноиллюстративный - ['книжноиллюстративный']
бюджетный - ['бюджетный']
маслюк - ['маслюков']
кузгатмакча - ['кузгатмакч']
многообразие - ['многообразие']
состав - ['состав']
пенсионер - ['пенсионер']
гагарин - ['гагарин']
полномочие - ['полномочие']
минемҗәлить - ['минемҗәлить']
ссайдашев - ['ссайдашев']
повесть - ['повести']
намерение - ['намерение']
заповедный - ['заповедный']
арифметика - ['арифметика']
роль - ['роль']
инфоцентр - ['инфоцентр']
транснефть - ['транснефть']
войско - ['войско']
тьютор - ['тьютор']
deck - ['deck']
госпошлина - ['госпошлина']
ипот - ['ипот']
приветствие - ['приветствие']
вводный - ['вводный']
инструменталист - ['инструменталист']
глава - ['глава']
разговор - ['разговор']
itлицейинтернат - ['itлицейинтернат']
достаточно - ['достаточно']
mathedu - ['mathedu']
брокерс - ['брокерс']
складской - ['складской']
это - ['это']
лазерный - ['лазерный']
eng - ['eng']
татитнефть - ['татитнефть']
мбудо - ['мбудо']
абитуриент - ['абитуриент']
x - ['x']
nostrud - ['nostrud']
deutsch - ['deutsch']
командировка - ['командировка']
сейчас - ['сейчас']
поздний - ['поздний']
logelco - ['logelco']
теория - ['теория']
бюро - ['бюро']
глаз - ['глаз']
организациипункт - ['организациипункт']
трансреалгаз - ['трансреалгаз']
scopus - ['scopus']
юфстудент - ['юфстудент']
александрович - ['александрович']
лицеяинтернат - ['лицеяинтернат']
фармацевтика - ['фармацевтика']
стобалльник - ['стобалльник']
ахмад - ['ахмад']
mmevassilievamailru - ['mmevassilievamailru']
августасреда - ['августасреда']
programming - ['programming']
очн - ['очн']
ninel - ['ninel']
developer - ['developer']
сковородка - ['сковородка']
генетика - ['генетика']
очнаяочнозаочнаязаочный - ['очнаяочнозаочнаязаочный']
инициатива - ['инициатива']
менеджерааналитик - ['менеджерааналитика']
коровин - ['коровин']
домашний - ['домашний']
адреспочта - ['адреспочта']
умка - ['умка']
спутник - ['спутник']
эволюционный - ['эволюционный']
телеперформанс - ['телеперформанс']
алексей - ['алексей']
именинник - ['именинник']
шахматы - ['шахматы']
категория - ['категория']
орда - ['орда']
быть - ['быть']
таргетолог - ['таргетолог']
понести - ['понести']
флип - ['флип']
векдекабрь - ['векдекабрь']
гиляз - ['гилязов']
юлия - ['юлия']
глухой - ['глухой']
гоуд - ['гоуд']
аз - ['аз']
процесс - ['процесс']
файл - ['файл']
медиааналитика - ['медиааналитика']
курортология - ['курортология']
ракетный - ['ракетный']
еа - ['еа']
гтольятти - ['гтольятти']
германия - ['германия']
фарма - ['фарма']
антонов - ['антонов']
реально - ['реально']
рфобращать - ['рфобращать']
аорта - ['аорта']
флешмоб - ['флешмоб']
itтерритория - ['itтерритория']
гост - ['гост']
тысруб - ['тысруб']
aqua - ['aqua']
учитель - ['учитель']
шутка - ['шутка']
works - ['works']
tatyanashreyamailru - ['tatyanashreyamailru']
режиссура - ['режиссура']
филиал - ['филиал']
национальный - ['национальный']
minim - ['minim']
ритейл - ['ритейл']
наставниктьютор - ['наставниктьютор']
itменеджмент - ['itменеджмент']
лнр - ['лнр']
геодезия - ['геодезия']
гали - ['гали']
азс - ['азс']
уйти - ['уйти']
xi - ['xi']
учиры - ['учир']
севастополь - ['севастополь']
абакуслугма - ['абакуслугма']
душный - ['душный']
дидактик - ['дидактик']
железо - ['железа']
ида - ['ида']
français - ['français']
забота - ['забота']
ннц - ['ннц']
исфнимк - ['исфнимк']
уникс - ['уникс']
ред - ['ред']
специалистстажёр - ['специалистстажёр']
фэшн - ['фэшн']
гарантсофт - ['гарантсофт']
взыскание - ['взыскание']
семинария - ['семинария']
аспопов - ['аспопов']
emailassozmailru - ['emailassozmailru']
ферганский - ['ферганский']
залежный - ['залежный']
здравоохранениездоровие - ['здравоохранениездоровие']
матка - ['матка']
конкурсфестиваль - ['конкурсфестиваль']
маркетологаналитик - ['маркетологаналитика']
побережье - ['побережье']
тело - ['тело']
tatarhistory - ['tatarhistory']
анатолиевич - ['анатолиевич']
подарок - ['подарок']
седов - ['седов']
интересно - ['интересно']
описать - ['описать']
неевклид - ['неевклидов']
mathcenterkpfuru - ['mathcenterkpfuru']
этнологияантропология - ['этнологияантропология']
вшб - ['вшб']
насбуклетлучший - ['насбуклетлучший']
акцент - ['акцент']
олимпиада - ['олимпиада']
антарктида - ['антарктида']
фитопатоген - ['фитопатоген']
другой - ['другой']
год - ['год']
ов - ['ов']
отчётность - ['отчётность']
кгма - ['кгма']
блок - ['блок']
excel - ['excel']
профком - ['профком']
тёплый - ['тёплый']
томскнефть - ['томскнефть']
эдельвейс - ['эдельвейс']
инсталляция - ['инсталляция']
флористра - ['флористра']
геоинформационный - ['геоинформационный']
ама - ['ама']
сарфть - ['сарфть']
рустемович - ['рустемович']
tsi - ['tsi']
мсу - ['мсу']
хинди - ['хинди']
итон - ['итон']
фармация - ['фармация']
ea - ['ea']
синоптик - ['синоптик']
эзләнүләр - ['эзләнүләр']
приволжский - ['приволжский']
сдавать - ['сдавать']
старотатарский - ['старотатарский']
работник - ['работник']
years - ['years']
табель - ['табель']
лобачевскогонаш - ['лобачевскогонаш']
маоу - ['маоу']
проводник - ['проводник']
онлайнтурнир - ['онлайнтурнир']
наноматериал - ['наноматериал']
администраторменеджер - ['администраторменеджер']
дом - ['дом']
имо - ['имо']
спорусский - ['спорусский']
иосифович - ['иосифович']
интерес - ['интерес']
телефонный - ['телефонный']
дгруппа - ['дгруппа']
чётко - ['чётко']
аванэксперт - ['аванэксперт']
собчак - ['собчак']
зф - ['зф']
процент - ['процент']
январь - ['январь']
софойло - ['софойло']
шоу - ['шоу']
реставратор - ['реставратор']
сбор - ['сбор']
рубмес - ['рубмес']
ильсурович - ['ильсурович']
аудиторный - ['аудиторный']
марат - ['марат']
инструментальный - ['инструментальный']
твёрдый - ['твёрдый']
показать - ['показать']
бутлера - ['бутлер']
мехатроника - ['мехатроника']
шопоголикра - ['шопоголикра']
правосудие - ['правосудие']
ретушь - ['ретушь']
икеа - ['икеа']
река - ['река']
теясакс - ['теясакс']
реальный - ['реальный']
нет - ['нет']
pgnovomoskovsk - ['pgnovomoskovsk']
владимир - ['владимир']
образованиепреподавание - ['образованиепреподавание']
дрезден - ['дрезден']
миссия - ['миссия']
рождение - ['рождение']
мать - ['мать']
каркина - ['каркина']
родный - ['родный']
псиохология - ['псиохология']
бурцев - ['бурцев']
d - ['d']
нельзя - ['нельзя']
если - ['если']
солженицын - ['солженицын']
hysterectomy - ['hysterectomy']
церемония - ['церемония']
тендер - ['тендер']
школаконференция - ['школаконференция']
icl - ['icl']
документ - ['документ']
гражданин - ['гражданин']
прививка - ['прививка']
статус - ['статус']
карбон - ['карбон']
химияметод - ['химияметод']
римма - ['римма']
петрович - ['петрович']
многие - ['многие']
течь - ['течь']
технопарк - ['технопарк']
дача - ['дача']
анкета - ['анкета']
мку - ['мку']
гражданство - ['гражданство']
лфк - ['лфк']
вы - ['вы']
срарус - ['срарус']
цвет - ['цвет']
радиофотоник - ['радиофотоник']
режим - ['режим']
питомец - ['питомец']
запрет - ['запрет']
фосфороса - ['фосфороса']
динамично - ['динамично']
планета - ['планета']
ви - ['ви']
aidarmailru - ['aidarmailru']
гарантировать - ['гарантировать']
аэробика - ['аэробика']
заседание - ['заседание']
рт - ['рт']
встать - ['встать']
англоязычный - ['англоязычный']
управлениигеография - ['управлениигеография']
визовый - ['визовый']
цн - ['цн']
корреспондент - ['корреспондент']
смешной - ['смешной']
наравне - ['наравне']
галим - ['галимов']
водный - ['водный']
надёжный - ['надёжный']
дворик - ['дворик']
open - ['open']
тимбилдинг - ['тимбилдинг']
учгодпрограмма - ['учгодпрограмма']
супрамолекулярный - ['супрамолекулярный']
итог - ['итог']
безвизовый - ['безвизовый']
присваивать - ['присваивать']
силантьев - ['силантьев']
спофизик - ['спофизик']
могила - ['могила']
внедрить - ['внедрить']
польша - ['польша']
опасность - ['опасность']
do - ['do']
array - ['array']
аксаков - ['аксаков']
ullamco - ['ullamco']
колледж - ['колледж']
ант - ['ант']
ни - ['ни']
soft - ['soft']
признанный - ['признанный']
трансдисциплинарный - ['трансдисциплинарный']
идиоматика - ['идиоматика']
биотехнолог - ['биотехнолог']
уничтожение - ['уничтожение']
конфедерация - ['конфедерация']
самойлов - ['самойлов']
результативный - ['результативный']
точный - ['точный']
careerru - ['careerru']
вроцлав - ['вроцлав']
банк - ['банк']
өчен - ['өчен']
inc - ['inc']
onliskill - ['onliskill']
михайловичstamgusevkpfuru - ['михайловичstamgusevkpfuru']
модулятор - ['модулятор']
юрисконсульт - ['юрисконсульт']
снятие - ['снятие']
advancelab - ['advancelab']
пористый - ['пористый']
admissionkpfuru - ['admissionkpfuru']
параметр - ['параметр']
оценка - ['оценка']
своевременно - ['своевременно']
инициатор - ['инициатор']
информатизация - ['информатизация']
вг - ['вг']
госслужба - ['госслужба']
конференция - ['конференция']
био - ['био']
медпрепарат - ['медпрепарат']
бакалавр - ['бакалавр']
повторять - ['повторять']
бибик - ['бибик']
радиационный - ['радиационный']
начало - ['начало']
критерий - ['критерий']
метрология - ['метрология']
например - ['например']
зорг - ['зорг']
визит - ['визит']
мухаметшин - ['мухаметшин']
отрасль - ['отрасль']
управленец - ['управленец']
буква - ['буква']
газета - ['газета']
филологияроманогерманский - ['филологияроманогерманский']
гарифуллин - ['гарифуллин']
камилевич - ['камилевич']
семипалатинск - ['семипалатинск']
трое - ['трое']
яндексдирект - ['яндексдирект']
афанасьев - ['афанасьев']
моина - ['моина']
самый - ['самый']
обмен - ['обмен']
пенсия - ['пенсия']
лобачевскогогусев - ['лобачевскогогусев']
эрозия - ['эрозия']
ex - ['ex']
привлечь - ['привлечь']
олегович - ['олегович']
роман - ['роман']
июль - ['июль']
педагоговорганизатор - ['педагоговорганизатор']
звание - ['звание']
нанофотоник - ['нанофотоник']
имплант - ['имплант']
сиситема - ['сиситема']
типичный - ['типичный']
музыка - ['музыка']
in - ['in']
начальник - ['начальник']
страница - ['страница']
образец - ['образец']
зэйнэбить - ['зэйнэбить']
биотехнологиясистёмный - ['биотехнологиясистёмный']
заказчик - ['заказчик']
магистрант - ['магистрант']
менять - ['менять']
граф - ['граф']
войти - ['войти']
угроза - ['угроза']
гуманитарный - ['гуманитарный']
распорядок - ['распорядок']
грант - ['грант']
шаблон - ['шаблон']
кфуесть - ['кфуести']
пациентка - ['пациентка']
восемьдесят - ['восемьдесят']
помощникстажёр - ['помощникстажёр']
раздел - ['раздел']
stem - ['stem']
электропоезд - ['электропоезд']
модуль - ['модуль']
лейтенант - ['лейтенант']
мультимедиастудия - ['мультимедиастудия']
судопроизводство - ['судопроизводство']
xxix - ['xxix']
туризм - ['туризм']
адресг - ['адресг']
смягчение - ['смягчение']
преподавание - ['преподавание']
романский - ['романский']
pozis - ['pozis']
каков - ['каков']
тронина - ['тронина']
президиум - ['президиум']
лента - ['лента']
историяистория - ['историяистория']
июнь - ['июнь']
интервью - ['интервью']
гиссофт - ['гиссофт']
العربية - ['العربية']
соцподдержка - ['соцподдержка']
вертолётный - ['вертолётный']
впервые - ['впервые']
моушндизайн - ['моушндизайн']
сразу - ['сразу']
xviixxвва - ['xviixxвва']
социологиясоциология - ['социологиясоциология']
метр - ['метр']
этаж - ['этаж']
татэнергосбыт - ['татэнергосбыт']
тенденция - ['тенденция']
trainer - ['trainer']
булгарий - ['булгария']
инженерконструктор - ['инженерконструктор']
кфуобразец - ['кфуобразец']
вмиитвмк - ['вмиитвмк']
mentor - ['mentor']
киви - ['киви']
геоморфология - ['геоморфология']
округанаш - ['округанаш']
ризван - ['ризван']
юный - ['юный']
ноябрьга - ['ноябрьга']
далее - ['далее']
заслуга - ['заслуга']
марсель - ['марсель']
классный - ['классный']
фалихович - ['фалихович']
земляк - ['земляк']
порусски - ['порусски']
мицветаев - ['мицветаев']
сертификат - ['сертификат']
гидроразыв - ['гидроразыв']
начать - ['начать']
квнщик - ['квнщик']
трудно - ['трудно']
llc - ['llc']
температура - ['температура']
омтс - ['омтс']
образ - ['образ']
выбывать - ['выбывать']
жемчужина - ['жемчужина']
рр - ['рр']
валериевич - ['валериевич']
хоздоговор - ['хоздоговор']
xviii - ['xviii']
ауд - ['ауд']
дм - ['дм']
изделияхкф - ['изделияхкф']
aliqua - ['aliqua']
доход - ['доход']
старший - ['старший']
май - ['май']
наско - ['наско']
осваивать - ['осваивать']
редактор - ['редактор']
гтукать - ['гтукать']
информатикаматематика - ['информатикаматематика']
тризна - ['тризна']
nisi - ['nisi']
прессслужба - ['прессслужба']
африканистика - ['африканистика']
ренессанс - ['ренессанс']
душанбе - ['душанбе']
странсогласно - ['странсогласно']
конференцзал - ['конференцзал']
имя - ['имя']
услугакт - ['услугакт']
нр - ['нр']
культурология - ['культурология']
proнаука - ['proнаука']
архитектура - ['архитектура']
говориться - ['говориться']
гставрополь - ['гставрополь']
зур - ['зур']
каталог - ['каталог']
информатикаинформационный - ['информатикаинформационный']
завтра - ['завтра']
немой - ['немой']
обрести - ['обрести']
ава - ['ава']
букет - ['букет']
топоснова - ['топоснова']
война - ['война']
бүгенгеся - ['бүгенгеся']
применить - ['применить']
кфуприурочить - ['кфуприурочить']
секретарьреферент - ['секретарьреферент']
гистология - ['гистология']
резерв - ['резерв']
беженец - ['беженец']
ооо - ['ооо']
внесение - ['внесение']
нижневартовск - ['нижневартовск']
ljm - ['ljm']
ожидать - ['ожидать']
брендкоммуникация - ['брендкоммуникация']
ой - ['ой']
имсалих - ['имсалих']
продукт - ['продукт']
ия - ['ия']
удк - ['удк']
технолог - ['технолог']
дружба - ['дружба']
возложение - ['возложение']
значение - ['значение']
emailipokpfuru - ['emailipokpfuru']
гетероструктура - ['гетероструктура']
преподаватель - ['преподаватель']
калькулятор - ['калькулятор']
закат - ['закат']
дестина - ['дестина']
нчи - ['нчи']
неуёмный - ['неуёмный']
sprachklub - ['sprachklub']
штрафной - ['штрафной']
иванович - ['иванович']
конструкториум - ['конструкториум']
luciano - ['luciano']
анатомия - ['анатомия']
ягымл - ['ягымл']
школеинтернат - ['школеинтернат']
portable - ['portable']
цель - ['цель']
сольный - ['сольный']
youtube - ['youtube']
нести - ['нести']
ильдарович - ['ильдарович']
встреча - ['встреча']
русяз - ['русяз']
практикум - ['практикум']
ринатович - ['ринатович']
экономикааудит - ['экономикааудит']
экономист - ['экономист']
рг - ['рг']
шагидуллин - ['шагидуллин']
куратор - ['куратор']
petroleum - ['petroleum']
земля - ['земля']
проспект - ['проспект']
китай - ['китай']
хәзинә - ['хәзинә']
усманов - ['усманов']
luidmilasavelyevakpfuru - ['luidmilasavelyevakpfuru']
контекст - ['контекст']
enim - ['enim']
уже - ['уже']
подпункт - ['подпункт']
chemistry - ['chemistry']
директор - ['директор']
природообустройство - ['природообустройство']
действие - ['действие']
геоконсалтинг - ['геоконсалтинг']
ноц - ['ноц']
какой - ['какой']
schlumberger - ['schlumberger']
секретарьгарифуллин - ['секретарьгарифуллин']
ниже - ['ниже']
филологиямеждународный - ['филологиямеждународный']
холдинг - ['холдинг']
сколково - ['сколково']
дубравушка - ['дубравушка']
причём - ['причём']
google - ['google']
календарь - ['календарь']
норма - ['норма']
распашка - ['распашка']
магистриум - ['магистриум']
телефон - ['телефон']
gmbh - ['gmbh']
дневный - ['дневный']
электронный - ['электронный']
project - ['project']
платить - ['платить']
фотогалерея - ['фотогалерея']
район - ['район']
ученыхдекабрьмеждународный - ['ученыхдекабрьмеждународный']
алгебра - ['алгебра']
улпрофессор - ['улпрофессор']
дискретный - ['дискретный']
репутация - ['репутация']
саранск - ['саранск']
преттль - ['преттль']
тыс - ['тыс']
университетаоб - ['университетаоб']
карасик - ['карасик']
ревгерович - ['ревгерович']
design - ['design']
тесно - ['тесно']
адресул - ['адресул']
новгород - ['новгород']
ремзд - ['ремзд']
кодекс - ['кодекс']
мтс - ['мтс']
квант - ['квант']
эксперт - ['эксперт']
новатор - ['новатор']
itiskpfuru - ['itiskpfuru']
интернетпроект - ['интернетпроект']
вакцина - ['вакцина']
проём - ['проём']
лизинговый - ['лизинговый']
инспекция - ['инспекция']
библиотека - ['библиотека']
центр - ['центр']
oksanaoksanamailru - ['oksanaoksanamailru']
журналистика - ['журналистика']
савостин - ['савостин']
кфумарт - ['кфумарт']
челнысегодня - ['челнысегодня']
فارسی - ['فارسی']
про - ['про']
гбугульма - ['гбугульма']
оксфордский - ['оксфордский']
пятница - ['пятница']
втб - ['втб']
саров - ['саров']
кружок - ['кружок']
титул - ['титул']
smart - ['smart']
тамчышоу - ['тамчышоу']
костный - ['костный']
номинант - ['номинант']
аммар - ['аммар']
internship - ['internship']
british - ['british']
физика - ['физика']
рифкатович - ['рифкатович']
junior - ['junior']
разгар - ['разгар']
кпф - ['кпф']
facebook - ['facebook']
чтец - ['чтец']
практика - ['практика']
ядерный - ['ядерный']
гвардия - ['гвардия']
инженерияметод - ['инженерияметод']
семейный - ['семейный']
свежий - ['свежий']
подлужный - ['подлужный']
оспаривать - ['оспаривать']
гарант - ['гарант']
операционный - ['операционный']
майхакатон - ['майхакатон']
отклик - ['отклик']
механика - ['механика']
философия - ['философия']
сержант - ['сержант']
агент - ['агент']
воздух - ['воздух']
приёмный - ['приёмный']
мастерприёмщик - ['мастерприёмщик']
хакатон - ['хакатон']
компетентный - ['компетентный']
этап - ['этап']
часы - ['часы']
знак - ['знак']
юнилевера - ['юнилевера']
klyucharovioutlookcom - ['klyucharovioutlookcom']
симптом - ['симптом']
emaillslkpfuru - ['emaillslkpfuru']
тв - ['тв']
патентный - ['патентный']
плата - ['плата']
вицеконсул - ['вицеконсул']
текст - ['текст']
проректор - ['проректор']
латып - ['латыпов']
ieee - ['ieee']
виталиевич - ['виталиевич']
workshop - ['workshop']
колорадо - ['колорадо']
школео - ['школео']
разрыв - ['разрыв']
йбитцер - ['йбитцер']
прототип - ['прототип']
психодиагностик - ['психодиагностик']
идентификация - ['идентификация']
гзеленодольск - ['гзеленодольск']
смартнаносистема - ['смартнаносистема']
портьера - ['портьера']
госкорпорация - ['госкорпорация']
неврология - ['неврология']
обоснование - ['обоснование']
family - ['family']
отъезд - ['отъезд']
анестезиолог - ['анестезиолог']
геннадиевич - ['геннадиевич']
шляпченков - ['шляпченков']
бургер - ['бургер']
викторович - ['викторович']
приехать - ['приехать']
exercitation - ['exercitation']
ege - ['ege']
гидэкскурсовод - ['гидэкскурсовод']
сад - ['сад']
такси - ['такси']
ггрегламент - ['ггрегламент']
знакомый - ['знакомый']
экспедиция - ['экспедиция']
корп - ['корп']
сыграть - ['сыграть']
логопедия - ['логопедия']
парамагнитный - ['парамагнитный']
goszakaz - ['goszakaz']
положить - ['положить']
равиль - ['равиль']
фггалимуллин - ['фггалимуллин']
дерматовенерология - ['дерматовенерология']
овз - ['овз']
бизнесинкубатор - ['бизнесинкубатор']
убеждённый - ['убеждённый']
кн - ['кн']
честно - ['честно']
зарип - ['зарипов']
арифметик - ['арифметик']
tilda - ['tilda']
ниимма - ['ниимма']
будетв - ['будетв']
валентин - ['валентин']
свч - ['свч']
вес - ['вес']
калачева - ['калачева']
марий - ['марий']
ефлов - ['ефлов']
чоо - ['чоо']
наиль - ['наиль']
сообщать - ['сообщать']
фабрика - ['фабрика']
хузиахмет - ['хузиахмет']
регистратура - ['регистратура']
альберо - ['альберо']
на - ['на']
словесный - ['словесный']
историяархеология - ['историяархеология']
двумятремитя - ['двумятремить']
мс - ['мс']
гк - ['гк']
надо - ['надо']
платформа - ['платформа']
webinar - ['webinar']
маратович - ['маратович']
саммитноябрьxvii - ['саммитноябрьxvii']
теологияменеджмент - ['теологияменеджмент']
охрана - ['охрана']
студгородок - ['студгородок']
п - ['п']
межуниверситетский - ['межуниверситетский']
adeihajbullinakpfuru - ['adeihajbullinakpfuru']
elit - ['elit']
диктант - ['диктант']
окладной - ['окладной']
ио - ['ио']
корэш - ['корэш']
мргафур - ['мргафур']
координация - ['координация']
жилой - ['жилой']
сергей - ['сергей']
пропаганда - ['пропаганда']
народный - ['народный']
конструкторский - ['конструкторский']
tel - ['tel']
лесной - ['лесной']
онлайнэфир - ['онлайнэфир']
хviiiхха - ['хviiiхха']
bks - ['bks']
ifteiecercмайiv - ['ifteiecercмайiv']
драматург - ['драматург']
чебоксары - ['чебоксары']
лань - ['лань']
доступ - ['доступ']
уфанета - ['уфанета']
фонд - ['фонд']
поручение - ['поручение']
атмосфера - ['атмосфера']
дх - ['дх']
oil - ['oil']
мпроспект - ['мпроспект']
втк - ['втк']
вакансия - ['вакансия']
татарин - ['татарин']
совет - ['совет']
контролёр - ['контролёр']
жкх - ['жкх']
не - ['не']
период - ['период']
сверхурочный - ['сверхурочный']
вкус - ['вкус']
теперь - ['теперь']
результативность - ['результативность']
вшитис - ['вшитис']
симметрично - ['симметрично']
ре - ['ре']
сфера - ['сфера']
астрономия - ['астрономия']
pprogukgmailcom - ['pprogukgmailcom']
госзакупка - ['госзакупка']
поиск - ['поиск']
лицеист - ['лицеист']
поджидать - ['поджидать']
шактый - ['шактый']
имнилобачевский - ['имнилобачевский']
rimsafiullinkpfuru - ['rimsafiullinkpfuru']
аниматораорганизатор - ['аниматораорганизатор']
сифилис - ['сифилис']
